"aa" = (/turf/space,/area/space)
"QH" = (/obj/map_data/eris{height = 5},/turf/space,/area/space)
"QI" = (/obj/effect/overmap/ship/eris,/turf/space,/area/space)

(1,1,1) = {"
aaaaaaaaaaaaaaaaaaaa
aaaaaaaaaaaaaaaaaaaa
aaaaaaaaaaaaaaaaaaaa
aaaaaaaaaaaaaaaaaaaa
aaaaaaaaaaaaaaaaaaaa
aaaaaaaaaaaaaaaaaaaa
aaaaaaaaaaaaaaaaaaaa
aaaaaaaaaaaaaaaaaaaa
aaaaaaaaaaaaaaaaaaaa
QHQIaaaaaaaaaaaaaaaa
"}
