"aaa" = (/turf/unsimulated/mask,/area/mine/gulag)
"aab" = (/obj/effect/decal/cleanable/rubble,/turf/unsimulated/mask,/area/mine/gulag)
"aac" = (/turf/simulated/wall/r_wall,/area/mine/gulag_base)
"aOv" = (/obj/structure/catwalk,/obj/structure/ore_box,/turf/simulated/floor/plating/under,/area/mine/gulag_base)
"bdH" = (/turf/unsimulated/mineral,/area/mine/gulag)
"bej" = (/obj/map_data/nadezda_labor,/turf/unsimulated/mineral,/area/mine/gulag)
"bfe" = (/turf/simulated/floor/asteroid,/area/mine/gulag)
"biY" = (/obj/structure/railing/grey{dir = 1},/turf/simulated/floor/asteroid,/area/mine/gulag_base)
"bvV" = (/obj/structure/catwalk,/turf/simulated/floor/plating/under,/area/mine/gulag_base)
"bQr" = (/obj/item/tool/pickaxe,/turf/simulated/floor/asteroid,/area/mine/gulag)
"cbS" = (/obj/item/device/lighting/glowstick/undark,/turf/simulated/floor/asteroid,/area/mine/gulag_base)
"csv" = (/obj/item/paper/laber_camp,/turf/simulated/floor/asteroid,/area/mine/gulag)
"dhP" = (/obj/structure/railing/grey,/turf/simulated/floor/asteroid,/area/mine/gulag_base)
"dGF" = (/obj/effect/decal/cleanable/rubble,/turf/simulated/floor/asteroid,/area/mine/gulag_base)
"dNv" = (/obj/effect/decal/cleanable/rubble,/turf/unsimulated/mineral,/area/mine/gulag)
"gxF" = (/obj/structure/railing/grey,/obj/item/stool,/turf/simulated/floor/asteroid,/area/mine/gulag_base)
"gMp" = (/obj/item/paper/laber_camp,/turf/simulated/floor/asteroid,/area/mine/gulag_base)
"gUn" = (/obj/structure/catwalk,/obj/structure/table/rack/shelf,/obj/item/storage/bag/ore,/obj/item/storage/bag/ore,/turf/simulated/floor/plating/under,/area/mine/gulag_base)
"hEv" = (/obj/structure/railing/grey{dir = 4},/turf/simulated/floor/asteroid,/area/mine/gulag_base)
"inv" = (/obj/structure/catwalk,/obj/item/paper/laber_camp,/turf/simulated/floor/plating/under,/area/mine/gulag_base)
"ivn" = (/obj/structure/catwalk,/obj/item/device/lighting/glowstick/undark,/turf/simulated/floor/plating/under,/area/mine/gulag_base)
"iQD" = (/obj/effect/step_trigger/hut_to_gulag_2_A,/obj/structure/multiz/stairs/enter/bottom{dir = 1},/turf/simulated/floor/tiled/white/violetcorener,/area/mine/gulag_base)
"jcT" = (/obj/structure/railing/grey{dir = 8},/turf/simulated/floor/asteroid,/area/mine/gulag_base)
"jdO" = (/obj/effect/decal/cleanable/rubble,/turf/simulated/floor/asteroid,/area/mine/gulag)
"jgA" = (/turf/unsimulated/mineral,/area/mine/gulag_base)
"jJR" = (/obj/structure/catwalk,/obj/structure/table/rack/shelf,/obj/item/tool/pickaxe,/obj/item/tool/pickaxe,/obj/item/tool/pickaxe,/obj/item/tool/pickaxe,/obj/item/tool/pickaxe,/obj/item/tool/hammer,/obj/item/tool/hammer,/obj/item/tool/hammer,/turf/simulated/floor/plating/under,/area/mine/gulag_base)
"kqT" = (/obj/structure/railing/grey{dir = 8},/obj/structure/railing/grey,/turf/simulated/wall,/area/mine/gulag_base)
"kQv" = (/obj/structure/railing/grey{dir = 4},/obj/structure/railing/grey,/obj/item/stool,/obj/item/paper/laber_camp,/turf/simulated/floor/asteroid,/area/mine/gulag_base)
"lEl" = (/obj/structure/catwalk,/obj/structure/table/rack/shelf,/obj/item/device/lighting,/obj/item/device/lighting,/turf/simulated/floor/plating/under,/area/mine/gulag_base)
"lPd" = (/obj/effect/step_trigger/hut_to_gulag2_B,/obj/structure/multiz/stairs/enter/bottom{dir = 1},/turf/simulated/floor/tiled/white/violetcorener,/area/mine/gulag_base)
"mtY" = (/obj/item/device/lighting/glowstick/undark,/turf/simulated/floor/asteroid,/area/mine/gulag)
"mZP" = (/obj/structure/catwalk,/obj/machinery/floodlight,/turf/simulated/floor/plating/under,/area/mine/gulag_base)
"noG" = (/obj/structure/catwalk,/obj/structure/table/rack/shelf,/obj/item/reagent_containers/food/snacks/mre,/obj/item/reagent_containers/food/snacks/mre,/obj/item/material/kitchen/utensil/spoon/mre,/turf/simulated/floor/plating/under,/area/mine/gulag_base)
"oeF" = (/obj/structure/railing/grey,/obj/structure/railing/grey{dir = 4},/turf/simulated/wall,/area/mine/gulag_base)
"rDv" = (/obj/item/tool/pickaxe,/obj/effect/decal/cleanable/rubble,/turf/simulated/floor/asteroid,/area/mine/gulag)
"rLe" = (/obj/item/material/kitchen/utensil/spoon/mre,/obj/effect/decal/cleanable/rubble,/turf/simulated/floor/asteroid,/area/mine/gulag)
"sjw" = (/obj/structure/railing/grey{dir = 8},/obj/structure/railing/grey,/obj/item/stool,/obj/item/paper/laber_camp,/turf/simulated/floor/asteroid,/area/mine/gulag_base)
"tJj" = (/turf/simulated/floor/asteroid,/area/mine/gulag_base)
"vGQ" = (/obj/effect/decal/cleanable/rubble,/obj/item/device/lighting/glowstick/undark,/turf/simulated/floor/asteroid,/area/mine/gulag)
"vHS" = (/turf/simulated/wall,/area/mine/gulag_base)

(1,1,1) = {"
bdHbdHbdHbdHbdHbdHbdHbdHbdHbdHbdHbdHbdHbdHbdHbdHbdHbdHbdHbdHbdHbdHbdHbdHbdHbdHbdHbdHbdHbdHbdHbdHbdHbdHbdHbdHbdHbdHbdHbdHbdHbdHbdHbdHbdHbdHbdHbdHbdHbdHbdHbdHbdHbdHbdHbdHbdHbdHbdHbdHbdHbdHbdHbdHbdH
bdHbdHbdHbdHbdHbdHbdHbdHbdHbdHbdHbdHbdHbdHbdHbdHbdHbdHbdHbdHbdHbdHbdHbdHbdHbdHbdHbdHbdHbdHbdHbdHbdHbdHbdHbdHbdHbdHbdHbdHbdHbdHbdHbdHbdHbdHbdHbdHbdHbdHbdHbdHbdHbdHbdHbdHbdHbdHbdHbdHbdHbdHbdHbdHbdH
bdHbdHbdHbdHbdHbdHbdHbdHbdHbdHbdHbdHbdHbdHbdHbdHbdHbdHbdHbdHbdHbdHbdHbdHbdHbdHbdHbdHbdHbdHbdHbdHbdHbdHbdHbdHbdHbdHbdHbdHbdHbdHbdHbdHbdHbdHbdHbdHbdHbdHbdHbdHbdHbdHbdHbdHbdHbdHbdHbdHbdHbdHbdHbdHbdH
bdHbdHbdHbdHbdHbdHbdHbdHbdHbdHbdHbdHbdHbdHbdHbdHbdHbdHbdHbdHbdHbdHbdHbdHbdHbdHbdHbdHbdHbdHbdHbdHbdHbdHbdHbdHbdHbdHbdHbdHbdHbdHbdHbdHbdHbdHbdHbdHbdHbdHbdHbdHbdHbdHbdHbdHbdHbdHbdHbdHbdHbdHbdHbdHbdH
bdHbdHbdHbdHbdHbdHbdHbdHbdHbdHbdHbdHbdHbdHbdHbdHbdHbdHbdHbdHbdHbdHbdHbdHbdHbdHbdHbdHbdHbdHbdHbdHbdHbdHbdHbdHbdHbdHbdHbdHbdHbdHbdHbdHbdHbdHbdHbdHbdHbdHbdHbdHbdHbdHbdHbdHbdHbdHbdHbdHbdHbdHbdHbdHbdH
bdHbdHbdHbdHbdHbdHbdHbdHbdHbdHbdHbdHbdHbdHbdHbdHbdHbdHbdHbdHbdHbdHbdHbdHbdHbdHbdHbdHbdHbdHbdHbdHbdHbdHbdHbdHbdHbdHbdHbdHbdHbdHbdHbdHbdHbdHbdHbdHbdHbdHbdHbdHbdHbdHbdHbdHbdHbdHbdHbdHbdHbdHbdHbdHbdH
bdHbdHbdHbdHbdHbdHbdHbdHbdHbdHbdHbdHbdHbdHbdHbdHbdHbdHbdHbdHbdHbdHbdHbdHbdHbdHbdHbdHbdHbdHbdHbdHbdHbdHbdHbdHbdHbdHbdHbdHbdHbdHbdHbdHbdHbdHbdHbdHbdHbdHbdHbdHbdHbdHbdHbdHbdHbdHbdHbdHbdHbdHbdHbdHbdH
bdHbdHbdHbdHbdHbdHbdHbdHbdHbdHbdHbdHbdHbdHbdHbdHbdHbdHbdHbdHbdHbdHbdHbdHbdHbdHbdHbdHbdHbdHbdHbdHbdHbdHbdHbdHbdHbdHbdHbdHbdHbdHbdHbdHbdHbdHbdHbdHbdHbdHbdHbdHbdHbdHbdHbdHbdHbdHbdHbdHbdHbdHbdHbdHbdH
bdHbdHbdHbdHbdHbdHbdHbdHbdHbdHbdHbdHbdHbdHbdHbdHbdHbdHbdHbdHbdHbdHbdHbdHbdHbdHbdHbdHbdHbdHbdHbdHbdHbdHbdHbdHbdHbdHbdHbdHbdHbdHbdHbdHbdHbdHbdHbdHbdHbdHbdHbdHbdHbdHbdHbdHbdHbdHbdHbdHbdHbdHbdHbdHbdH
bdHbdHbdHbdHbdHbdHbdHbdHbdHbdHbdHbdHbdHbdHbdHbdHbdHbdHbdHbdHbdHbdHbdHbdHbdHbdHbdHbdHbdHbdHbdHbdHbdHbdHbdHbdHbdHbdHbdHbdHbdHbdHbdHbdHbdHbdHbdHbdHbdHbdHbdHbdHbdHbdHbdHbdHbdHbdHbdHbdHbdHbdHbdHbdHbdH
bdHbdHbdHbdHbdHbdHbdHbdHbdHbdHbdHbdHbdHbdHbdHbdHbdHbdHbdHbdHbdHbdHbdHbdHbdHbdHbdHbdHbdHbdHbdHbdHbdHbdHbdHbdHbdHbdHbdHbdHbdHbdHbdHbdHbdHbdHbdHbdHbdHbdHbdHbdHbdHbdHbdHbdHbdHbdHbdHbdHbdHbdHbdHbdHbdH
bdHbdHbdHbdHbdHbdHbdHbdHbdHbdHbdHbdHbdHbdHbdHbdHbdHbdHbdHbdHbdHbdHbdHbdHbdHbdHbdHbdHbdHbdHbdHbdHbdHbdHbdHbdHbdHbdHbdHbdHbdHbdHbdHbdHbdHbdHbdHbdHbdHbdHbdHbdHbdHbdHbdHbdHbdHbdHbdHbdHbdHbdHbdHbdHbdH
bdHbdHbdHbdHbdHbdHbdHbdHbdHbdHbdHbdHbdHbdHbdHbdHbdHbdHbdHbdHbdHbdHbdHbdHbdHbdHbdHbdHbdHbdHbdHbdHbdHbdHbdHbdHbdHbdHbdHbdHbdHbdHbdHbdHbdHbdHbdHbdHbdHbdHbdHbdHbdHbdHbdHbdHbdHbdHbdHbdHbdHbdHbdHbdHbdH
bdHbdHbdHbdHbdHbdHbdHbdHbdHbdHbdHbdHbdHbdHbdHbdHbdHbdHbdHbdHbdHbdHbdHbdHbdHbdHbdHbdHbdHbdHbdHbdHbdHbdHbdHbdHbdHbdHbdHbdHbdHbdHbdHbdHbdHbdHbdHbdHbdHbdHbdHbdHbdHbdHbdHbdHbdHbdHbdHbdHbdHbdHbdHbdHbdH
bdHbdHbdHbdHbdHbdHbdHbdHbdHbdHbdHbdHbdHbdHbdHbdHbdHbdHbdHbdHbdHbdHbdHbdHbdHbdHbdHbdHbdHbdHbdHbdHbdHbdHbdHbdHbdHbdHbdHbdHbdHbdHbdHbdHbdHbdHbdHbdHbdHbdHbdHbdHbdHbdHbdHbdHbdHbdHbdHbdHbdHbdHbdHbdHbdH
bdHbdHbdHbdHbdHbdHbdHbdHbdHbdHbdHbdHbdHbdHbdHbdHbdHbdHbdHbdHbdHbdHbdHbdHbdHbdHbdHbdHbdHbdHbdHbdHbdHbdHbdHbdHbdHbdHbdHbdHbdHbdHbdHbdHbdHbdHbdHbdHbdHbdHbdHbdHbdHbdHbdHbdHbdHbdHbdHbdHbdHbdHbdHbdHbdH
bdHbdHbdHbdHbdHbdHbdHbdHbdHbdHbdHaaaaaaaaabdHaaaaaaaaaaaaaaaaaabdHaaaaaaaaabdHbdHaaaaaaaaabdHaaabdHbdHbdHbdHaaaaaaaaabdHaaaaaabdHbdHbdHbdHbdHbdHbdHbdHbdHbdHbdHbdHbdHbdHbdHbdHbdHbdHbdHbdHbdHbdHbdH
bdHbdHbdHbdHbdHbdHbdHbdHbdHbdHbdHaaaaaaaaabdHaaaaaabdHbdHaaaaaabdHaaaaaaaaaaaaaaabdHbdHaaaaaaaaaaaaaaaaaaaaaaaabdHaaabdHaaaaaabdHaaabdHbdHbdHbdHbdHbdHbdHbdHbdHbdHbdHbdHbdHbdHbdHbdHbdHbdHbdHbdHbdH
bdHbdHbdHbdHbdHbdHbdHbdHbdHbdHaaaaaaaaaaaaaaabdHaaaaaaaaaaaaaaaaaabdHaaaaaaaaaaaaaaaaaaaaaaaaaaaaaaaaaaaabdHaaaaaaaaaaaaaaaaaaaaabdHaaaaaabdHbdHbdHbdHbdHbdHbdHbdHbdHbdHbdHbdHbdHbdHbdHbdHbdHbdHbdH
bdHbdHbdHbdHbdHbdHbdHbdHbdHaaaaaaaaaaaaaaabdHaaaaaaaaaaaaaaaaaaaaaaaabdHaaaaaaaaaaaaaaaaaaaaaaaaaaabdHaaaaaaaaaaaaaaaaaaaaaaaaaaabdHaaaaaaaaabdHbdHbdHbdHbdHbdHbdHbdHbdHbdHbdHbdHbdHbdHbdHbdHbdHbdH
bdHbdHbdHbdHbdHbdHbdHbdHaaaaaaaaaaaabdHbdHaaaaaaaaaaaaaaaaaaaaaaaaaaaaaaaaaaaaaaaaaaaaaaaabdHbdHaaaaaaaaaaaaaaaaaaaaaaaaaaaaaaaaaaaaaaaaaaaaabdHbdHbdHbdHbdHbdHbdHbdHbdHbdHbdHbdHbdHbdHbdHbdHbdHbdH
bdHbdHbdHbdHbdHbdHbdHaaaaaaaaaaaaaaabdHaaaaaaaaaaaaaaaaaaaaaaaaaaaaaaaaaaaaaaaaaaaaaaaaaaaaaaaaaaaaaaaaaaaaaaaaaaaaaaaaaaaaaaaaaaaaaaaaaaaaaaaaabdHbdHbdHbdHbdHbdHbdHbdHbdHbdHbdHbdHbdHbdHbdHbdHbdH
bdHbdHbdHbdHbdHbdHbdHbdHaaaaaaaaaaaaaaaaaaaaaaaaaaaaaaaaaaaaaaaaaaaaaaaaaaaaaaaaaaaaaaaaaaaaaaaaaaaaaaaaaaaaaaaaaaaaaaaaaaaaaaaaaaaaaaaaaaaaaaaabdHbdHbdHbdHbdHbdHbdHbdHbdHbdHbdHbdHbdHbdHbdHbdHbdH
bdHbdHbdHbdHbdHaaaaaaaaabdHaaaaaaaaaaaaaaaaaabdHbdHaaaaaaaaaaaaaaaaaaaaaaaaaaaaaaaaaaaaaaaaaaaaaaaaaaaaaaaaaaaaaaaaaaaaaaaaaaaaaaaaaaaaaaaaaaaaabdHbdHbdHbdHbdHbdHbdHbdHbdHbdHbdHbdHbdHbdHbdHbdHbdH
bdHbdHbdHbdHaaaaaaaaaaaaaaaaaaaaaaaaaaaaaaaaabdHbdHaaaaaaaaaaaaaaaaaaaaaaaaaaaaaaaaaaaaaaaaaaaaaaaaaaaaaaaaaaaaaaaaaaaaaaaaaaaaaaaaaaaaaaaaaaaaaaaaaaabdHbdHbdHbdHbdHbdHbdHbdHbdHbdHbdHbdHbdHbdHbdH
bdHbdHaaaaaaaaaaaaaaaaaaaaaaaaaaaaaaaaaaaaaaaaaaaaaaaaaaaaaaaaaaaaaaaaaaaaaaaaaaaaaaaaaaaaaaaaaaaaaaaaaaaaaaaaaaaaaaaaaaaaaaaaaaaaaaaaaaaaaaaaaabdHbdHbdHbdHbdHbdHbdHbdHbdHbdHbdHbdHbdHbdHbdHbdHbdH
bdHbdHbdHaaaaaaaaaaaaaaaaaaaaaaaaaaaaaaaaaaaaaaaaaaaaaaaaaaaaaaaaaaaaaaaaaaaaaaaaaaaaaaaaaaaaaaaaaaaaaaaaaaaaaaaaaaaaaaaaaaaaaaaaaaaaaaaaaaaaaaaaaaaaabdHbdHbdHbdHbdHbdHbdHbdHbdHbdHbdHbdHbdHbdHbdH
bdHbdHbdHaaaaaaaaaaaaaaaaaaaaaaaaaaaaaaaaaaaaaaaaaaaaaaaaaaaaaaaaaaaaaaaaaaaaaaaaaaaaaaaaaaaaaaaaaaaaaaaaaaaaaaaaaaaaaaaaaaaaaaaaaaaaaaaaaaaaaaaaaaaaaaaabdHbdHbdHbdHbdHbdHbdHbdHbdHbdHbdHbdHbdHbdH
bdHbdHaaaaaaaaaaaaaaaaaaaaaaaaaaaaaaaaaaaaaaaaaaaaaaaaaaaaaaaaaaaaaaabdHbdHaaaaaaaaaaaaaaaaaaaaaaaaaaaaaaaaabdHbdHaaaaaaaaaaaaaaaaaaaaaaaaaaaaaaaaaaaaaaaaaabdHbdHbdHbdHbdHbdHbdHbdHbdHbdHbdHbdHbdH
bdHbdHaaaaaaaaaaaaaaaaaaaaaaaaaaaaaaaaaaaaaaaaaaaaaaaaaaaaaaaaaaaabdHbdHbdHbdHaaaaaaaaaaaaaaaaaaaaaaaaaaaaaabdHbdHaaaaaaaaaaaaaaaaaaaaaaaaaaabdHaaaaaaaaaaaabdHbdHbdHbdHbdHbdHbdHbdHbdHbdHbdHbdHbdH
bdHbdHaaaaaaaaaaaaaaabdHbdHbdHaaaaaaaaaaaaaaaaaaaaaaaaaaaaaaaaaaaaaaabdHbdHaaaaaaaaaaaaaaaaaaaaaaaaaaaaaaaaabdHaaaaaaaaaaaaaaaaaaaaaaaaaaaaaabdHaaabdHbdHbdHbdHbdHbdHbdHbdHbdHbdHbdHbdHbdHbdHbdHbdH
bdHbdHbdHaaaaaaaaaaaabdHbdHbdHaaaaaaaaaaaaaaaaaaaaaaaaaaaaaaaaaaaaaaaaaaaaaaaaaaaaaaaaaaaaaaaaaabdHaaaaaaaaaaaaaaaaaaaaaaaaaaaaaaaaaaaaaaabdHaaaaaaaaaaaaaaabdHbdHbdHbdHbdHbdHbdHbdHbdHbdHbdHbdHbdH
bdHbdHbdHbdHaaaaaaaaabdHaaaaaaaaaaaaaaaaaabdHaaaaaaaaaaaaaaaaaaaaaaaaaaaaaaaaaaaaaaaaaaaaaaaaaaaaaaaaaaaaaaaaaaaaaaaaaaaaaaaaaaaaaaaaaaaaaaaaaaaaaaaaaaaabdHbdHbdHbdHbdHbdHbdHbdHbdHbdHbdHbdHbdHbdH
bdHbdHbdHaaaaaaaaaaaaaaaaaaaaaaaaaaaaaaaaaaaaaaaaaaaaaaaaaaaaaaaaaaaaaaaaaaaaaaaaaaaaaaaaaaaaaaaaaaaaaaaaaaaaaaaaaaaaaaaaaaaaaaaabdHaaaaaaaaaaaaaaaaaaaaabdHbdHbdHbdHbdHbdHbdHbdHbdHbdHbdHbdHbdHbdH
bdHbdHaaaaaaaaaaaaaaaaaaaaaaaaaaaaaaaaaaaaaaaaaaaaaaaaaaaaaaaaaaaaaaaaaaaaaaaaaaaaaaaaaaaaaaaaaaaaaaaaaaaaaaaaaaaaaaaaaaaaaaaaaaaaaaaaaaaaaaaaaaaaaaaaaaaaaabdHbdHbdHbdHbdHbdHbdHbdHbdHbdHbdHbdHbdH
bdHbdHaaaaaaaaaaaaaaaaaaaaaaaaaaaaaaaaaaaaaaaaaaaaaaaaaaaaaaaaaaaaaaaaaaaaaaaaaaaaaaaaaaaaaaaaaaaaaaaaaaaaaaaaaaaaaaaaaaaaaaaaaaaaaaaaaaaaaaaaaaaaabdHbdHaaabdHbdHbdHbdHbdHbdHbdHbdHbdHbdHbdHbdHbdH
bdHbdHaaaaaaaaaaaaaaaaaaaaaaaaaaaaaaaaaaaaaaaaaaaaaaaaaaaaaaaaaaaaaaaaaaaaaaaaaaabdHbdHaaaaaaaaaaaaaaaaaaaaaaaaaaaaaaaaaaaaaaaaaaaaaaaaaaaaaaaaaaaabdHaaaaaabdHbdHbdHbdHbdHbdHbdHbdHbdHbdHbdHbdHbdH
bdHbdHbdHaaaaaaaaaaaaaaaaaaaaaaaaaaaaaaaaaaaaaaaaaaaaaaaaaaaaaaaaaaaaaaaaaaaaaaaabdHaaaaaaaaaaaaaaaaaaaaaaaaaaaaaaaaaaaaaaaaaaaaaaaaaaaaaabdHaaaaaabdHaaaaaabdHbdHbdHbdHbdHbdHbdHbdHbdHbdHbdHbdHbdH
bdHbdHbdHaaaaaaaaaaaaaaaaaaaaaaaaaaaaaaaaaaaaaaaaaaaaaaaaaaaaaaaaaaaaaaaaaaaaaaaaaaaaaaaaaaaaaaaaaaaaaaaaaaaaaaaaabdHaaaaaaaaaaaaaaaaaaaaabdHaaaaaaaaaaaaaaabdHbdHbdHbdHbdHbdHbdHbdHbdHbdHbdHbdHbdH
bdHbdHaaaaaaaaaaaaaaaaaaaaaaaaaaaaaaaaaaaaaaaaaaaaabdHbdHaaaaaaaaaaaaaaaaaaaaaaaaaaaaaaaaaaaaaaaaaaaaaaaaaaaaaaaaabdHaaaaaaaaaaaaaaaaaaaaabdHaaaaaaaaaaaaaaabdHbdHbdHbdHbdHbdHbdHbdHbdHbdHbdHbdHbdH
bdHbdHbdHbdHaaaaabaaaaaaaaaaaaaaaaaaaaabQrjdOaaaaaaaaaaaaaaaaaaaaaaaaaaaaaaaaaaaaaaaaaaaaaaaaaaaaaaaaaaaaaaaaaaaaaaaaaaaaaaaaaaaaaaaaaaaaaaaaaaaaaaaaaaaaaaabdHbdHbdHbdHbdHbdHbdHbdHbdHbdHbdHbdHbdH
bdHbdHaaaaaajdOrLejdOaaabfejdOaaaaaaaaajdOjdOaaaaaaaaaaaaaaaaaaaaaaaaaaaaaaaaaaaaaaaaaaaaaaaaaaaaaaaaaaaaaaaaaaaaaaaaaaaaaaaaaaaaaaaaaaaaaaaaaaaaaabdHbdHaaabdHbdHbdHbdHbdHbdHbdHbdHbdHbdHbdHbdHbdH
bdHbdHaaaaaabfemtYbfeaaajdObfeaaaaaaaaamtYjdOaaaaaaaaaaaaaaaaaaaaaaaaaaaaaaaaaaaaaaaaaaaaabdHbdHaaaaaaaaaaaaaaaaaaaaaaaaaaaaaaaaaaaaaaaaaaaaaaaaaaaaaabdHaaabdHbdHbdHbdHbdHbdHbdHbdHbdHbdHbdHbdHbdH
bdHbdHbfebfejdObfebfebQrbfejdOjdObfebfejdObfebfejdOjdOaaaaaaaaaaaaaaaaaaaaaaaaaaaaaaaaaaaabdHbdHaaaaaaaaaaaaaaaaaaaaaaaaaaaaaaaaaaaaaaaaaaaaaaaaaaaaaaaaaaaabdHbdHbdHbdHbdHbdHbdHbdHbdHbdHbdHbdHbdH
bdHbdHjdOjdObfejdObfebfebfebfevGQjdObfejdOjdOvGQvGQjdOjdObfeaaaaaaaaaaaaaaaaaaaaaaaaaaabdHbdHaaaaaaaaaaaaaaaaaaaaaaaaaaaaaaaaaaaaaaaaaaaaaaaaaaaaaaaaaaaaaaabdHbdHbdHbdHbdHbdHbdHbdHbdHbdHbdHbdHbdH
bdHbdHdNvjdOjdObfebfebfebfecsvbfebfejdOjdOjdOjdObfejdOjdObfeaaaaaaaaaaaaaaaaaaaaaaaaaaabdHbdHaaaaaaaaaaaaaaaaaaaaaaaaaaaaaaaaaaaaaaaaaaaaaaaaaaaaaabdHaaaaaabdHbdHbdHbdHbdHbdHbdHbdHbdHbdHbdHbdHbdH
bdHbdHbdHbfejdObfebfejdObfejdObfejdObfebfebfejdOjdOjdOaaaaaaaaaaaaaaaaaaaaaaaaaaaaaaaaaaaaaaaaaaaaaaaaaaaaaaaaaaaaaaaaaaaaaaaaaaaaaaaaaaaaaaaaaabdHaaaaaaaaabdHbdHbdHbdHbdHbdHbdHbdHbdHbdHbdHbdHbdH
bdHbdHtJjtJjgMpdGFcbStJjtJjtJjtJjdGFtJjtJjtJjtJjjdOrDvaaaaaaaaaaaaaaaaaaaaaaaaaaaaaaaaaaaaaaaaaaaaaaaaaaaaaaaaaaaaaaaaaaaaaaaaaaaaaaaaaaaaaaaaaaaaaaaaaaaaaabdHbdHbdHbdHbdHbdHbdHbdHbdHbdHbdHbdHbdH
bdHbdHtJjdhPoeFbvVbvVsjwgxFkQvbvVbvVkqTdhPdGFdGFjdOjdOaaaaaaaaaaaaaaaaaaaaaaaaaaaaaaaaaaaaaaaaaaaaaaaaaaaaaaaaaaaaaaaaaaaaaaaaaaaaaaaaaaaaaaaaaaaaaaaaaaabdHbdHbdHbdHbdHbdHbdHbdHbdHbdHbdHbdHbdHbdH
bdHbdHhEvgUngUnbvVbvVlEllEljJRbvVbvVnoGnoGjcTtJjmtYbfeaaaaaaaaaaaaaaabdHaaaaaaaaaaaaaaaaaaaaaaaaaaaaaaaaaaaaaaaaaaaaaaaaaaaaaaaaaaaaaaaaaaaaaaaaaaaaaabdHbdHbdHbdHbdHbdHbdHbdHbdHbdHbdHbdHbdHbdHbdH
bdHbdHhEvbvVbvVivnbvVbvVbvVbvVivninvbvVbvVjcTtJjbfebfeaaaaaaaaaaaaaaabdHbdHaaaaaaaaaaaaaaaaaaaaaaaaaaaaaaaaaaaaaaaaaaaaaaaaaaaaaaaaaaaaaaaaaaaaaaaaaaaaaaaaabdHbdHbdHbdHbdHbdHbdHbdHbdHbdHbdHbdHbdH
bdHbdHhEvgUngUnbvVbvVlEllEljJRbvVbvVnoGnoGjcTtJjbfejdOaaaaaaaaaaaaaaabdHbdHaaaaaaaaaaaaaaaaaaaaaaaaaaaaaaaaaaaaaaaaaaaaaaaaaaaaaaaaaaaaaaaaaaaaaaaaaaaaaaaaabdHbdHbdHbdHbdHbdHbdHbdHbdHbdHbdHbdHbdH
bdHbdHhEvbvVbvVbvVivnbvVbvVbvVbvVbvVbvVbvVjcTtJjmtYbfeaaaaaaaaaaaaaaaaaaaaaaaaaaaaaaaaaaaaaaaaaaaaaaaaaaaaaaaaaaaabdHbdHbdHaaaaaaaaaaaaaaaaaaaaaaaaaaabdHaaabdHbdHbdHbdHbdHbdHbdHbdHbdHbdHbdHbdHbdH
bdHbdHhEvbvVbvVbvVbvVbvVbvVbvVbvVivnbvVbvVjcTtJjbfejdOaaaaaaaaaaaaaaaaaaaaaaaaaaaaaaaaaaaaaaaaaaaaaaaaaaaaaaaaaaaabdHaaaaaaaaaaaaaaaaaaaaaaaaaaaaaaaaabdHaaabdHbdHbdHbdHbdHbdHbdHbdHbdHbdHbdHbdHbdH
bdHbdHhEvbvVbvVinvaaciQDaaclPdaacbvVbvVbvVjcTtJjcsvjdOjdOjdOaaaaaaaaaaaaaaaaaaaaaaaaaaaaaaaaaaaaaaaaaaaaaaaaaaaaaaaaaaaaaaaaaaaaaaaaaaaaaaaaaaaaaaaaaaaaaaaabdHbdHbdHbdHbdHbdHbdHbdHbdHbdHbdHbdHbdH
bdHbdHhEvbvVbvVbvVaacaacaacaacaacbvVbvVbvVjcTtJjbfebfebfebQraaaaaaaaaaaaaaaaaaaaaaaaaaaaaaaaaaaaaaaaaaaaaaaaaaaaaaaaaaaaaaaaaaaaaaaaaaaaaaaaaaaaaaaaaaaaabdHbdHbdHbdHbdHbdHbdHbdHbdHbdHbdHbdHbdHbdH
bdHbdHhEvmZPmZPbvVbvVbvVbvVbvVbvVbvVmZPmZPjcTtJjbfemtYaaaaaaaaaaaaaaaaaaaaaaaaaaaaaaaaaaaaaaaaaaaaaaaaaaaaaaaaaaaaaaaaaaaaaaaaaaaaaaaaaaaaaaaaaaaaaaaaaaabdHbdHbdHbdHbdHbdHbdHbdHbdHbdHbdHbdHbdHbdH
bdHbdHhEvbvVbvVbvVbvVbvVbvVbvVbvVbvVbvVbvVjcTtJjbfebfeaaaaaaaaaaaaaaaaaaaaaaaaaaaaaaaaaaaaaaaaaaaaaaaaaaaaaaaaaaaaaaaaaaaaaaaaaaaaaaaaaaaaaaaaaaaaaaaabdHaaabdHbdHbdHbdHbdHbdHbdHbdHbdHbdHbdHbdHbdH
bdHbdHhEvaOvaOvbvVaOvaOvaOvaOvaOvbvVaOvaOvjcTtJjbfejdOaaaaaaaaaaaaaaaaaaaaaaaaaaaaaaaaaaaaaaaaaaaaaaaaaaaaaaaaaaaaaaaaaaaaaaaaaaaaaaaaaaaaaaaaaaaaaaaabdHaaabdHbdHbdHbdHbdHbdHbdHbdHbdHbdHbdHbdHbdH
bdHbdHhEvbvVbvVbvVbvVbvVbvVbvVbvVbvVbvVbvVjcTcbSbfebQraaaaaaaaaaaaaaaaaaaaaaaaaaaaaaaaaaaaaaaaaaaaaaaaaaaaaaaaaaaaaaaaaaaaaaaaaaaaaaaaaaaabdHaaaaaaaaabdHbdHbdHbdHbdHbdHbdHbdHbdHbdHbdHbdHbdHbdHbdH
bdHbdHhEvaOvaOvbvVaOvaOvaOvaOvaOvbvVaOvaOvjcTtJjbfejdOaaaaaaaaaaaaaaaaaaaaaaaaaaaaaaaaaaaaaaaaaaaaaaaaaaabdHaaaaaaaaaaaaaaaaaaaaaaaaaaaaaaaaabdHaaaaaaaaabdHbdHbdHbdHbdHbdHbdHbdHbdHbdHbdHbdHbdHbdH
bdHbdHvHSbiYbiYbiYbiYbiYbiYbiYbiYbiYbiYbiYvHStJjbfejdObdHaaaaaaaaaaaaaaaaaaaaabdHaaaaaabdHaaaaaabdHaaabdHaaaaaabdHaaaaaabdHbdHaaaaaabdHaaaaaaaaabdHaaaaaabdHbdHbdHbdHbdHbdHbdHbdHbdHbdHbdHbdHbdHbdH
bdHbdHtJjtJjtJjjgAjgAjgAtJjtJjtJjtJjjgAtJjtJjtJjjdObdHbdHaaaaaaaaaaaaaaabdHbdHaaaaaaaaaaaabdHbdHbdHaaabdHaaabdHaaaaaaaaaaaabdHaaaaaabdHaaaaaabdHbdHaaaaaaaaabdHbdHbdHbdHbdHbdHbdHbdHbdHbdHbdHbdHbdH
bdHbdHbdHbdHbdHbdHbdHbdHbdHbdHbdHbdHbdHbdHbdHbdHbdHbdHbdHbdHbdHbdHbdHbdHbdHbdHbdHbdHbdHbdHbdHbdHbdHbdHbdHbdHbdHbdHbdHbdHbdHbdHbdHbdHbdHbdHbdHbdHbdHbdHbdHbdHbdHbdHbdHbdHbdHbdHbdHbdHbdHbdHbdHbdHbdH
bejbdHbdHbdHbdHbdHbdHbdHbdHbdHbdHbdHbdHbdHbdHbdHbdHbdHbdHbdHbdHbdHbdHbdHbdHbdHbdHbdHbdHbdHbdHbdHbdHbdHbdHbdHbdHbdHbdHbdHbdHbdHbdHbdHbdHbdHbdHbdHbdHbdHbdHbdHbdHbdHbdHbdHbdHbdHbdHbdHbdHbdHbdHbdHbdH
"}
