"aa" = (/turf/template_noop,/area/template_noop)
"ab" = (/obj/structure/lattice,/turf/template_noop,/area/template_noop)
"ac" = (/turf/simulated/floor/plating/under,/area/template_noop)
"ad" = (/obj/structure/girder,/turf/simulated/floor/plating/under,/area/template_noop)
"ae" = (/obj/random/scrap/sparse_even,/turf/simulated/floor/tiled/derelict/white_small_edges,/area/template_noop)
"af" = (/obj/random/junk,/mob/living/simple_animal/hostile/roomba/slayer,/turf/simulated/floor/tiled/derelict/white_small_edges,/area/template_noop)
"ag" = (/turf/simulated/wall/untinted/onestar_reinforced,/area/template_noop)
"ah" = (/turf/simulated/floor/tiled/derelict/white_big_edges,/area/template_noop)
"ai" = (/obj/random/scrap/dense_weighted,/turf/simulated/floor/plating/under,/area/template_noop)
"aj" = (/obj/structure/sign/faction/derelict2,/turf/simulated/wall/untinted/onestar_reinforced,/area/template_noop)
"ak" = (/obj/machinery/door/airlock/sandstone{name = "OneStar Airlock"},/turf/simulated/floor/tiled/derelict,/area/template_noop)
"al" = (/turf/simulated/floor/tiled/derelict/red_white_edges,/area/template_noop)
"am" = (/obj/random/structures/os,/turf/simulated/floor/tiled/derelict/white_big_edges,/area/template_noop)
"an" = (/obj/structure/closet/onestar,/turf/simulated/floor/tiled/derelict/white_small_edges,/area/template_noop)
"ao" = (/obj/structure/bed/chair/custom/onestar,/turf/simulated/floor/tiled/derelict/white_red_edges,/area/template_noop)
"ap" = (/obj/random/junk,/turf/simulated/floor/tiled/derelict/white_big_edges,/area/template_noop)
"aq" = (/obj/structure/sign/faction/derelict1,/turf/simulated/wall/untinted/onestar,/area/template_noop)
"as" = (/obj/structure/sign/faction/derelict2,/turf/simulated/wall/untinted/onestar,/area/template_noop)
"au" = (/obj/effect/window_lwall_spawn/smartspawn/onestar,/turf/simulated/floor/tiled/dark/brown_perforated,/area/template_noop)
"av" = (/obj/structure/closet/onestar/tier2/mineral,/turf/simulated/floor/tiled/derelict/red_white_edges,/area/template_noop)
"aw" = (/obj/item/remains,/turf/simulated/floor/tiled/derelict/white_small_edges,/area/template_noop)
"ay" = (/obj/structure/salvageable/computer_os,/turf/simulated/floor/tiled/derelict/red_white_edges,/area/template_noop)
"az" = (/obj/machinery/multistructure/bioreactor_part/console,/turf/simulated/floor/tiled/derelict/red_white_edges,/area/template_noop)
"aA" = (/obj/machinery/door/airlock/external{icon_state = "door_locked"; locked = 1},/turf/simulated/floor/tiled/derelict/white_red_edges,/area/template_noop)
"aB" = (/obj/structure/bed/chair/custom/onestar/red{dir = 1},/turf/simulated/floor/tiled/derelict/red_white_edges,/area/template_noop)
"aC" = (/obj/structure/closet/onestar/tier1/mineral/empty,/turf/simulated/floor/tiled/derelict/red_white_edges,/area/template_noop)
"aD" = (/obj/effect/floor_decal/industrial/loading,/obj/machinery/door/airlock/external{icon_state = "door_locked"; locked = 1},/turf/simulated/floor/tiled/techmaint_cargo,/area/template_noop)
"aE" = (/obj/effect/floor_decal/industrial/loading{dir = 1},/obj/machinery/door/airlock/external{icon_state = "door_locked"; locked = 1},/turf/simulated/floor/tiled/techmaint_cargo,/area/template_noop)
"aF" = (/obj/random/pack/machine,/turf/simulated/floor/tiled/derelict/red_white_edges,/area/template_noop)
"aG" = (/turf/simulated/wall/untinted/onestar,/area/template_noop)
"aI" = (/obj/structure/catwalk,/obj/structure/ore_box,/turf/template_noop,/area/template_noop)
"aJ" = (/obj/structure/catwalk,/turf/template_noop,/area/template_noop)
"aK" = (/obj/structure/lattice,/obj/item/weapon/storage/bag/ore,/turf/template_noop,/area/template_noop)
"aL" = (/turf/simulated/mineral,/area/template_noop)
"aM" = (/obj/structure/railing{dir = 1},/turf/template_noop,/area/template_noop)
"aN" = (/obj/structure/railing{dir = 1},/obj/structure/railing{dir = 4},/turf/template_noop,/area/template_noop)
"aO" = (/obj/structure/railing{dir = 1},/obj/structure/railing{dir = 8},/obj/structure/inflatable/wall,/turf/template_noop,/area/template_noop)
"aP" = (/obj/structure/railing{dir = 1},/obj/structure/inflatable/wall,/turf/template_noop,/area/template_noop)
"aQ" = (/obj/structure/inflatable/wall,/turf/template_noop,/area/template_noop)
"aR" = (/obj/machinery/computer/telecomms/server,/turf/simulated/floor/tiled/derelict/red_white_edges,/area/template_noop)
"aS" = (/obj/structure/railing{dir = 4},/obj/structure/inflatable/wall,/turf/template_noop,/area/template_noop)
"aT" = (/obj/structure/catwalk,/obj/structure/inflatable/door,/turf/template_noop,/area/template_noop)
"aU" = (/obj/structure/railing{dir = 8},/obj/structure/inflatable/wall,/turf/template_noop,/area/template_noop)
"aV" = (/turf/simulated/mineral/random,/area/template_noop)
"aW" = (/obj/structure/inflatable/door,/turf/template_noop,/area/template_noop)
"aX" = (/obj/structure/sign/directions/medical{dir = 1; icon_state = "direction_med"},/turf/simulated/wall/untinted/onestar_reinforced,/area/template_noop)
"aY" = (/obj/structure/sign/directions/evac{dir = 8; icon_state = "direction_evac"},/obj/structure/sign/directions/engineering{dir = 8; icon_state = "direction_eng"; pixel_y = 10},/turf/simulated/wall/untinted/onestar,/area/template_noop)
"aZ" = (/obj/random/junk,/turf/simulated/floor/tiled/derelict/white_red_edges,/area/template_noop)
"ba" = (/obj/random/structures/os,/turf/simulated/floor/tiled/derelict/white_red_edges,/area/template_noop)
"bb" = (/obj/item/weapon/gun/projectile/handmade_pistol,/obj/machinery/power/port_gen/pacman/scrap,/turf/simulated/floor/tiled/derelict/white_small_edges,/area/template_noop)
"bc" = (/obj/random/junk,/turf/simulated/floor/tiled/derelict/white_small_edges,/area/template_noop)
"bd" = (/obj/machinery/door/airlock/centcom{icon_state = "door_locked"; locked = 1},/turf/simulated/floor/tiled/derelict/white_small_edges,/area/template_noop)
"be" = (/obj/machinery/door/airlock/centcom{icon_state = "door_locked"; locked = 1},/turf/simulated/floor/tiled/derelict/white_red_edges,/area/template_noop)
"bf" = (/obj/item/remains,/turf/simulated/floor/tiled/derelict/red_white_edges,/area/template_noop)
"bg" = (/obj/machinery/door/airlock/centcom{icon_state = "door_locked"; locked = 1},/turf/simulated/floor/tiled/derelict/red_white_edges,/area/template_noop)
"bh" = (/obj/random/structures/os,/turf/simulated/floor/tiled/derelict/red_white_edges,/area/template_noop)
"bi" = (/obj/item/weapon/storage/bag/ore,/turf/simulated/floor/tiled/derelict/red_white_edges,/area/template_noop)
"bj" = (/obj/structure/catwalk,/obj/item/weapon/storage/bag/ore,/turf/template_noop,/area/template_noop)
"bk" = (/obj/structure/inflatable/door,/obj/structure/catwalk,/turf/template_noop,/area/template_noop)
"bl" = (/obj/structure/lattice,/obj/item/weapon/tool/pickaxe/onestar,/obj/item/remains,/turf/template_noop,/area/template_noop)
"bI" = (/obj/effect/floor_decal/industrial/loading{dir = 1},/turf/simulated/floor/tiled/techmaint_cargo,/area/template_noop)
"bJ" = (/obj/structure/table/onestar,/turf/simulated/floor/tiled/derelict/red_white_edges,/area/template_noop)
"bQ" = (/obj/effect/floor_decal/industrial/loading,/turf/simulated/floor/tiled/techmaint_cargo,/area/template_noop)
"bT" = (/obj/structure/bed/chair/custom/onestar{dir = 8},/turf/simulated/floor/tiled/derelict/red_white_edges,/area/template_noop)
"bY" = (/obj/effect/floor_decal/industrial/outline/yellow,/turf/simulated/floor/tiled/techmaint_cargo,/area/template_noop)
"ch" = (/turf/simulated/floor/tiled/derelict/white_red_edges,/area/template_noop)
"fR" = (/obj/random/scrap/sparse_even,/turf/simulated/floor/tiled/derelict/red_white_edges,/area/template_noop)
"jf" = (/mob/living/simple_animal/hostile/roomba/gun_ba,/turf/simulated/floor/tiled/derelict/white_red_edges,/area/template_noop)
"nf" = (/obj/random/junk,/turf/simulated/floor/tiled/derelict/red_white_edges,/area/template_noop)
"qP" = (/obj/structure/catwalk,/mob/living/simple_animal/hostile/roomba/slayer,/turf/template_noop,/area/template_noop)
"sD" = (/mob/living/simple_animal/hostile/roomba/gun_ba,/turf/simulated/floor/tiled/derelict/red_white_edges,/area/template_noop)
"xF" = (/mob/living/simple_animal/hostile/roomba/slayer,/turf/simulated/floor/tiled/derelict/red_white_edges,/area/template_noop)
"Vr" = (/mob/living/simple_animal/hostile/roomba/boomba,/turf/simulated/floor/tiled/derelict/white_red_edges,/area/template_noop)

(1,1,1) = {"
aaaaaaaaabaaaaababababababababababababaaaaaaaaaaaa
aaaaaaababadabadagabacacacacacaiadababaaaaaaaaaaaa
aaaaababadacacacagagagagakagagagagababaaaaaaaaaaaa
aaababacacacacacagapamahahahapapagabaaaaaaaaaaaaaa
aaabacacacacacaiagahahahahahahamagaaaaaaaaaaaaaaaa
aaabacacagagagagagagajaXakagagagagagauauauauagaaaa
aaabacacagawananaGaZchchchchaoaoaochaZaZaZbaagaaaa
aaabacacagbbafbcbdchchchchjfchchchchchaZaZbaagaaaa
ababacaiaganananaGchchchchchchchchchchaZaZaZagaaaa
adabagagagaYaGaGaqaGaGaGakaGaGaGaGchchchchchagaaaa
acacacaebechchchchchchchchchchchasaGaGakaGaGagaaaa
abadagagagchchchchchVrchchchchchaubfalalalavagaaaa
acacababagchchbababachchaZaZchchbJbTalalalavagaaaa
abababaaagbgaGaGaGaGaGaGaGchchchbJbTalxFalbhagaaaa
aaaaaaaaagalalayayazazalagaAagaAagbialalalbhagaaaa
aaaaaaaaagalalaBaBaBaBalaubQagbIaualalalalbhagaaaa
aaaaaaaaagalalalalalalalaubYagbYaubiavavaCaCagaaaa
aaaaagagagalsDalnfagagagagaDagaEagagagagagagagaaaa
aaaaagaFnfalalalalbhagaIaIaJaJaJaJaKaLaLababaLaLaa
aaaaagaFalalalalalbhagaIaIaJqPaJbjaJbkabaLabaLaaaa
aaaaagaFalalalalalalagaMaNaJaJaOaPaQaLblaLaLaLaaaa
aaaaagaRalalalalalalagaQaSaTaTaUaVaLaVaLaLaaaaaaaa
aaaaagaRfRaRaRaRaRfRagaLaLaJaJaLaLaLaLaLaLaLaaaaaa
aaaaagagagagagagagagagaLaVaWaWaQaVaLaLaLaLaLaaaaaa
aaaaaaaaaaaaaaaaaaaaaaaaaLaaaaaaaaaaaaaaaaaaaaaaaa
"}
