//MAP CONVERTED BY dmm2tgm.py THIS HEADER COMMENT PREVENTS RECONVERSION, DO NOT REMOVE
"a" = (
/turf/simulated/floor/tiled/steel/monofloor,
/area/deepmaint)
"b" = (
/obj/random/mob/psi_monster/low_chance,
/turf/simulated/floor/tiled/techmaint_panels,
/area/deepmaint)
"c" = (
/turf/simulated/wall,
/area/deepmaint)
"d" = (
/obj/random/junk,
/turf/simulated/floor/tiled/techmaint_cargo,
/area/deepmaint)
"e" = (
/obj/random/pack/machine,
/turf/simulated/floor/tiled/techmaint_perforated,
/area/deepmaint)
"f" = (
/turf/simulated/floor/tiled/techmaint,
/area/deepmaint)
"g" = (
/obj/structure/table/rack/shelf,
/obj/random/pack/tech_loot,
/obj/random/pack/tech_loot,
/obj/random/pack/tech_loot/low_chance,
/obj/random/pack/tech_loot/low_chance,
/obj/random/ammo,
/obj/random/ammo_fancy,
/obj/random/ammo_lowcost,
/turf/simulated/floor/tiled/techmaint_perforated,
/area/deepmaint)
"h" = (
/obj/random/junk,
/turf/simulated/floor/tiled/techmaint,
/area/deepmaint)
"i" = (
/obj/item/stool,
/turf/simulated/floor/tiled/techmaint_perforated,
/area/deepmaint)
"j" = (
/obj/random/cluster/psi_monster/low_chance,
/turf/simulated/floor/tiled/techmaint,
/area/deepmaint)
"k" = (
/obj/structure/table/standard,
/obj/random/pack/rare/low_chance,
/turf/simulated/floor/tiled/techmaint_perforated,
/area/deepmaint)
"l" = (
/obj/structure/table/standard,
/obj/random/pack/rare/low_chance,
/obj/random/pack/rare,
/turf/simulated/floor/tiled/techmaint_perforated,
/area/deepmaint)
"m" = (
/obj/structure/table/rack/shelf,
/obj/random/pack/cloth,
/obj/random/pack/cloth,
/obj/random/pack/cloth/low_chance,
/turf/simulated/floor/tiled/techmaint_perforated,
/area/deepmaint)
"n" = (
/turf/simulated/floor/tiled/techmaint_cargo,
/area/deepmaint)
"o" = (
/obj/structure/table/rack/shelf,
/obj/random/pack/tech_loot,
/obj/random/pack/tech_loot,
/obj/random/pack/tech_loot/low_chance,
/obj/random/pack/tech_loot/low_chance,
/obj/machinery/light/small{
	dir = 1
	},
/obj/random/ammo,
/obj/random/ammo_fancy,
/obj/random/ammo_lowcost,
/turf/simulated/floor/tiled/techmaint_perforated,
/area/deepmaint)
"p" = (
/obj/structure/table/rack/shelf,
/obj/random/pack/cloth,
/obj/random/pack/cloth,
/obj/random/pack/cloth/low_chance,
/obj/machinery/light/small,
/turf/simulated/floor/tiled/techmaint_perforated,
/area/deepmaint)
"y" = (
/turf/simulated/floor/tiled/techmaint_panels,
/area/deepmaint)
"B" = (
/obj/random/mob/psi_monster/low_chance,
/turf/simulated/floor/tiled/steel/monofloor,
/area/deepmaint)
"T" = (
/obj/random/mob/psi_monster/low_chance,
/turf/simulated/floor/tiled/techmaint,
/area/deepmaint)
"V" = (
/obj/random/cluster/psi_monster/lower_chance,
/turf/simulated/floor/tiled/techmaint,
/area/deepmaint)

(1,1,1) = {"
a
a
a
B
a
a
a
a
a
B
a
"}
(2,1,1) = {"
y
c
c
c
c
c
c
c
c
c
y
"}
(3,1,1) = {"
y
c
e
e
e
e
e
e
e
c
y
"}
(4,1,1) = {"
b
d
f
f
f
j
f
h
f
n
b
"}
(5,1,1) = {"
y
c
g
h
i
k
i
f
m
c
y
"}
(6,1,1) = {"
y
c
o
f
i
l
i
V
p
c
y
"}
(7,1,1) = {"
y
c
g
T
i
k
i
f
m
c
y
"}
(8,1,1) = {"
b
d
f
f
f
j
f
h
f
d
b
"}
(9,1,1) = {"
y
c
e
e
e
e
e
e
e
c
y
"}
(10,1,1) = {"
y
c
c
c
c
c
c
c
c
c
y
"}
(11,1,1) = {"
a
a
a
a
B
a
a
a
B
a
a
"}
