//MAP CONVERTED BY dmm2tgm.py THIS HEADER COMMENT PREVENTS RECONVERSION, DO NOT REMOVE
"a" = (
/turf/simulated/floor/tiled/white/brown_platform,
/area/deepmaint)
"b" = (
/turf/simulated/floor/tiled/white/cargo,
/area/deepmaint)
"c" = (
/turf/simulated/wall,
/area/deepmaint)
"d" = (
/obj/structure/salvageable/implant_container,
/turf/simulated/floor/tiled/white/techfloor_grid,
/area/deepmaint)
"f" = (
/turf/simulated/floor/tiled/white/panels,
/area/deepmaint)
"g" = (
/obj/structure/salvageable/computer,
/turf/simulated/floor/tiled/white/panels,
/area/deepmaint)
"k" = (
/obj/structure/salvageable/personal,
/turf/simulated/floor/tiled/white/gray_platform,
/area/deepmaint)
"l" = (
/obj/structure/salvageable/implant_container,
/turf/simulated/floor/tiled/white/cargo,
/area/deepmaint)
"s" = (
/obj/structure/table/standard,
/obj/random/pack/cloth,
/obj/random/pack/cloth,
/obj/random/pack/rare,
/obj/random/firstaid/low_chance,
/obj/random/medical_lowcost/low_chance,
/turf/simulated/floor/tiled/white/gray_platform,
/area/deepmaint)
"t" = (
/turf/simulated/floor/tiled/white/brown_perforated,
/area/deepmaint)
"u" = (
/obj/structure/table/standard,
/obj/random/pack/cloth,
/obj/random/pack/cloth,
/obj/random/pack/cloth,
/obj/random/pack/rare,
/obj/random/firstaid/low_chance,
/obj/random/medical_lowcost/low_chance,
/turf/simulated/floor/tiled/white/gray_platform,
/area/deepmaint)
"v" = (
/obj/machinery/sleeper/sarcophagus/random{
	dir = 4
	},
/turf/simulated/floor/tiled/white/gray_platform,
/area/deepmaint)
"w" = (
/obj/machinery/sleeper/sarcophagus/random{
	dir = 8
	},
/turf/simulated/floor/tiled/white/gray_platform,
/area/deepmaint)
"x" = (
/obj/machinery/light/small{
	dir = 8
	},
/obj/structure/salvageable/implant_container,
/turf/simulated/floor/tiled/white/techfloor_grid,
/area/deepmaint)
"y" = (
/obj/machinery/light/small{
	dir = 4;
	pixel_y = 0
	},
/obj/structure/salvageable/implant_container,
/turf/simulated/floor/tiled/white/techfloor_grid,
/area/deepmaint)
"z" = (
/obj/machinery/light/small{
	dir = 1
	},
/turf/simulated/floor/tiled/white/panels,
/area/deepmaint)
"A" = (
/obj/structure/table/standard,
/obj/random/pouch/low_chance,
/turf/simulated/floor/tiled/white/techfloor_grid,
/area/deepmaint)
"B" = (
/obj/random/mob/psi_monster/low_chance,
/turf/simulated/floor/tiled/white/cargo,
/area/deepmaint)
"N" = (
/obj/random/mob/psi_monster/low_chance,
/turf/simulated/floor/tiled/white/brown_perforated,
/area/deepmaint)
"O" = (
/obj/structure/salvageable/deepmaints_cryopod,
/turf/simulated/floor/tiled/white/cargo,
/area/deepmaint)
"P" = (
/obj/random/mob/psi_monster/low_chance,
/turf/simulated/floor/tiled/white/panels,
/area/deepmaint)
"S" = (
/obj/structure/table/standard,
/obj/random/pack/cloth,
/obj/random/pack/cloth,
/obj/random/pack/rare,
/obj/random/firstaid/low_chance,
/obj/random/dungeon_gun_energy/low_chance,
/obj/random/medical/low_chance,
/turf/simulated/floor/tiled/white/gray_platform,
/area/deepmaint)
"T" = (
/obj/structure/table/standard,
/obj/random/psi_megafauna,
/turf/simulated/floor/tiled/white/techfloor_grid,
/area/deepmaint)

(1,1,1) = {"
a
a
a
a
B
b
b
a
a
a
a
"}
(2,1,1) = {"
a
c
c
c
c
c
z
s
v
v
a
"}
(3,1,1) = {"
a
d
x
k
c
O
P
t
t
t
a
"}
(4,1,1) = {"
a
B
f
S
c
O
f
t
t
N
a
"}
(5,1,1) = {"
b
A
f
l
c
O
f
S
w
w
b
"}
(6,1,1) = {"
b
g
P
f
f
P
f
f
f
P
b
"}
(7,1,1) = {"
b
T
f
l
c
O
f
S
v
v
b
"}
(8,1,1) = {"
a
B
f
S
c
O
f
t
t
N
a
"}
(9,1,1) = {"
a
d
y
k
c
O
P
t
t
t
a
"}
(10,1,1) = {"
a
c
c
c
c
c
z
u
w
w
a
"}
(11,1,1) = {"
a
a
a
a
B
b
b
a
a
a
a
"}
