"a" = (/turf/simulated/floor/tiled/steel/brown_platform,/area/deepmaint)
"b" = (/obj/item/remains/xeno,/obj/random/junk,/turf/simulated/floor/tiled/white/techfloor_grid,/area/deepmaint)
"c" = (/turf/simulated/wall,/area/deepmaint)
"d" = (/obj/structure/kitchenspike,/turf/simulated/floor/tiled/white/techfloor_grid,/area/deepmaint)
"e" = (/obj/machinery/gibber,/turf/simulated/floor/tiled/white/techfloor_grid,/area/deepmaint)
"f" = (/obj/item/remains/human,/obj/random/junk,/turf/simulated/floor/tiled/white/techfloor_grid,/area/deepmaint)
"g" = (/obj/item/remains/mouse,/obj/random/junk,/obj/machinery/light/small{dir = 8},/obj/structure/table/standard,/obj/random/knife,/obj/random/knife,/obj/random/surgery_tool,/turf/simulated/floor/tiled/white/gray_platform,/area/deepmaint)
"h" = (/obj/random/junk,/obj/random/junk,/obj/random/cluster/psi_monster/low_chance,/turf/simulated/floor/tiled/white/gray_platform,/area/deepmaint)
"i" = (/obj/random/junk,/turf/simulated/floor/tiled/white/gray_platform,/area/deepmaint)
"j" = (/obj/item/remains/human,/obj/random/junk,/turf/simulated/floor/tiled/white/gray_platform,/area/deepmaint)
"k" = (/obj/machinery/door/airlock{name = "Kitchen Freezer"; req_access = list(28)},/turf/simulated/floor/tiled/steel/cargo,/area/deepmaint)
"l" = (/obj/random/junk,/turf/simulated/floor/tiled/white/cargo,/area/deepmaint)
"m" = (/turf/simulated/floor/tiled/white/brown_perforated,/area/deepmaint)
"n" = (/obj/random/junk,/turf/simulated/floor/tiled/white/brown_perforated,/area/deepmaint)
"o" = (/obj/item/remains/human,/turf/simulated/floor/tiled/white/brown_perforated,/area/deepmaint)
"p" = (/turf/simulated/floor/tiled/white/cargo,/area/deepmaint)
"q" = (/obj/random/junk,/turf/simulated/floor/tiled/steel/brown_platform,/area/deepmaint)
"r" = (/obj/random/junk,/obj/random/junk,/turf/simulated/floor/tiled/steel/brown_platform,/area/deepmaint)
"s" = (/obj/item/remains/mouse,/obj/random/junk,/obj/random/cluster/psi_monster/low_chance,/turf/simulated/floor/tiled/white/gray_platform,/area/deepmaint)
"t" = (/obj/random/junk,/obj/machinery/light/small{dir = 4; pixel_y = 0},/obj/structure/table/standard,/obj/random/knife,/obj/random/melee/low_chance,/turf/simulated/floor/tiled/white/gray_platform,/area/deepmaint)
"u" = (/turf/simulated/floor/tiled/white/panels,/area/deepmaint)
"v" = (/obj/random/junk,/turf/simulated/floor/tiled/white/panels,/area/deepmaint)
"w" = (/obj/item/remains/mouse,/turf/simulated/floor/tiled/white/panels,/area/deepmaint)
"x" = (/obj/random/junk,/obj/structure/table/standard,/obj/random/knife,/obj/random/knife,/obj/random/pouch/low_chance,/turf/simulated/floor/tiled/white/gray_platform,/area/deepmaint)
"y" = (/obj/item/remains/mouse,/obj/random/junk,/obj/structure/table/standard,/obj/random/knife,/obj/random/melee/low_chance,/turf/simulated/floor/tiled/white/gray_platform,/area/deepmaint)
"z" = (/obj/machinery/light/small{dir = 1},/turf/simulated/floor/tiled/white/cargo,/area/deepmaint)
"A" = (/obj/structure/table/standard,/obj/random/junkfood/low_chance,/obj/random/junkfood/low_chance,/turf/simulated/floor/tiled/white/brown_perforated,/area/deepmaint)
"B" = (/obj/structure/table/standard,/obj/random/junk,/obj/random/junkfood/low_chance,/obj/random/junkfood/low_chance,/obj/random/lathe_disk/advanced/low_chance,/turf/simulated/floor/tiled/white/brown_perforated,/area/deepmaint)
"C" = (/obj/structure/table/standard,/obj/random/psi_megafauna,/obj/random/lathe_disk/advanced/low_chance,/turf/simulated/floor/tiled/white/brown_perforated,/area/deepmaint)
"D" = (/obj/structure/table/standard,/obj/random/junkfood/low_chance,/obj/random/junkfood/low_chance,/obj/random/lathe_disk/advanced/low_chance,/turf/simulated/floor/tiled/white/brown_perforated,/area/deepmaint)
"E" = (/obj/structure/table/standard,/obj/random/junkfood/low_chance,/turf/simulated/floor/tiled/white/brown_perforated,/area/deepmaint)

(1,1,1) = {"
aaaaaaaaaaa
accccccccca
acdedcdedca
acdbdcdfdca
acghicistca
acxjiciiyca
acckccckcca
almnoznmnpq
rcABCcADEca
auvwvuuvwvq
qqraaqqqqaa
"}
