//MAP CONVERTED BY dmm2tgm.py THIS HEADER COMMENT PREVENTS RECONVERSION, DO NOT REMOVE
"a" = (
/turf/simulated/floor/tiled/steel/brown_platform,
/area/deepmaint)
"b" = (
/obj/item/remains/xeno,
/obj/random/junk,
/turf/simulated/floor/tiled/white/techfloor_grid,
/area/deepmaint)
"c" = (
/turf/simulated/wall,
/area/deepmaint)
"d" = (
/obj/structure/kitchenspike,
/turf/simulated/floor/tiled/white/techfloor_grid,
/area/deepmaint)
"e" = (
/obj/machinery/gibber,
/turf/simulated/floor/tiled/white/techfloor_grid,
/area/deepmaint)
"f" = (
/obj/item/remains/human,
/obj/random/junk,
/turf/simulated/floor/tiled/white/techfloor_grid,
/area/deepmaint)
"g" = (
/obj/item/remains/mouse,
/obj/random/junk,
/obj/random/cluster/psi_monster/low_chance,
/turf/simulated/floor/tiled/white/gray_platform,
/area/deepmaint)
"h" = (
/obj/random/junk,
/obj/random/junk,
/obj/random/cluster/psi_monster/low_chance,
/turf/simulated/floor/tiled/white/gray_platform,
/area/deepmaint)
"i" = (
/obj/random/junk,
/turf/simulated/floor/tiled/white/gray_platform,
/area/deepmaint)
"j" = (
/obj/item/remains/human,
/obj/random/junk,
/turf/simulated/floor/tiled/white/gray_platform,
/area/deepmaint)
"k" = (
/obj/machinery/door/airlock{
	name = "Kitchen Freezer";
	req_access = list(28)
	},
/turf/simulated/floor/tiled/steel/cargo,
/area/deepmaint)
"l" = (
/obj/random/junk,
/turf/simulated/floor/tiled/white/cargo,
/area/deepmaint)
"m" = (
/turf/simulated/floor/tiled/white/brown_perforated,
/area/deepmaint)
"n" = (
/obj/random/junk,
/turf/simulated/floor/tiled/white/brown_perforated,
/area/deepmaint)
"o" = (
/obj/item/remains/human,
/turf/simulated/floor/tiled/white/brown_perforated,
/area/deepmaint)
"p" = (
/turf/simulated/floor/tiled/white/cargo,
/area/deepmaint)
"q" = (
/obj/random/junk,
/turf/simulated/floor/tiled/steel/brown_platform,
/area/deepmaint)
"r" = (
/obj/random/junk,
/obj/random/junk,
/turf/simulated/floor/tiled/steel/brown_platform,
/area/deepmaint)
"s" = (
/obj/structure/table/standard,
/obj/random/junkfood/low_chance,
/obj/random/junkfood/low_chance,
/turf/simulated/floor/tiled/white/brown_perforated,
/area/deepmaint)
"t" = (
/obj/structure/table/standard,
/obj/random/junk,
/obj/random/junkfood/low_chance,
/obj/random/junkfood/low_chance,
/obj/random/lathe_disk/advanced/low_chance,
/turf/simulated/floor/tiled/white/brown_perforated,
/area/deepmaint)
"u" = (
/turf/simulated/floor/tiled/white/panels,
/area/deepmaint)
"v" = (
/obj/random/junk,
/turf/simulated/floor/tiled/white/panels,
/area/deepmaint)
"w" = (
/obj/item/remains/mouse,
/turf/simulated/floor/tiled/white/panels,
/area/deepmaint)
"x" = (
/obj/item/remains/mouse,
/obj/random/junk,
/obj/machinery/light/small{
	dir = 8
	},
/obj/structure/table/standard,
/obj/random/knife,
/obj/random/knife,
/obj/random/surgery_tool,
/turf/simulated/floor/tiled/white/gray_platform,
/area/deepmaint)
"y" = (
/obj/random/junk,
/obj/machinery/light/small{
	dir = 4;
	pixel_y = 0
	},
/obj/structure/table/standard,
/obj/random/knife,
/obj/random/melee/low_chance,
/turf/simulated/floor/tiled/white/gray_platform,
/area/deepmaint)
"z" = (
/obj/machinery/light/small{
	dir = 1
	},
/obj/random/mob/psi_monster/low_chance,
/turf/simulated/floor/tiled/white/cargo,
/area/deepmaint)
"B" = (
/obj/structure/table/standard,
/obj/random/junkfood/low_chance,
/obj/random/junkfood/low_chance,
/obj/random/lathe_disk/advanced/low_chance,
/turf/simulated/floor/tiled/white/brown_perforated,
/area/deepmaint)
"D" = (
/obj/random/junk,
/obj/random/mob/psi_monster/low_chance,
/turf/simulated/floor/tiled/white/panels,
/area/deepmaint)
"E" = (
/obj/item/remains/mouse,
/obj/random/junk,
/obj/structure/table/standard,
/obj/random/knife,
/obj/random/melee/low_chance,
/turf/simulated/floor/tiled/white/gray_platform,
/area/deepmaint)
"F" = (
/obj/random/junk,
/obj/structure/table/standard,
/obj/random/knife,
/obj/random/knife,
/obj/random/pouch/low_chance,
/turf/simulated/floor/tiled/white/gray_platform,
/area/deepmaint)
"P" = (
/obj/item/remains/mouse,
/obj/random/mob/psi_monster/low_chance,
/turf/simulated/floor/tiled/white/panels,
/area/deepmaint)
"Q" = (
/obj/structure/table/standard,
/obj/random/psi_megafauna,
/obj/random/lathe_disk/advanced/low_chance,
/turf/simulated/floor/tiled/white/brown_perforated,
/area/deepmaint)
"R" = (
/obj/structure/table/standard,
/obj/random/junkfood/low_chance,
/turf/simulated/floor/tiled/white/brown_perforated,
/area/deepmaint)
"T" = (
/obj/random/mob/psi_monster/low_chance,
/turf/simulated/floor/tiled/steel/brown_platform,
/area/deepmaint)

(1,1,1) = {"
a
a
T
a
a
a
a
a
r
a
q
"}
(2,1,1) = {"
a
c
c
c
c
c
c
l
c
u
q
"}
(3,1,1) = {"
a
c
d
d
x
F
c
m
s
v
r
"}
(4,1,1) = {"
a
c
e
b
h
j
k
n
t
P
a
"}
(5,1,1) = {"
a
c
d
d
i
i
c
o
Q
v
a
"}
(6,1,1) = {"
T
c
c
c
c
c
c
z
c
u
q
"}
(7,1,1) = {"
a
c
d
d
i
i
c
n
s
u
q
"}
(8,1,1) = {"
a
c
e
f
g
i
k
m
B
D
q
"}
(9,1,1) = {"
a
c
d
d
y
E
c
n
R
w
q
"}
(10,1,1) = {"
a
c
c
c
c
c
c
p
c
v
a
"}
(11,1,1) = {"
a
a
T
a
a
a
a
q
a
q
a
"}
