//MAP CONVERTED BY dmm2tgm.py THIS HEADER COMMENT PREVENTS RECONVERSION, DO NOT REMOVE
"a" = (
/turf/simulated/floor/tiled/steel/brown_platform,
/area/deepmaint)
"b" = (
/turf/simulated/wall,
/area/deepmaint)
"c" = (
/obj/effect/window_lwall_spawn/smartspawn,
/turf/simulated/floor/plating,
/area/deepmaint)
"e" = (
/obj/structure/table/woodentable,
/obj/random/rations,
/turf/simulated/floor/asteroid/dirt,
/area/deepmaint)
"f" = (
/obj/structure/table/woodentable,
/obj/random/rations,
/obj/random/rations,
/obj/random/rations,
/turf/simulated/floor/asteroid/dirt,
/area/deepmaint)
"g" = (
/obj/machinery/portable_atmospherics/hydroponics,
/turf/simulated/floor/asteroid/dirt,
/area/deepmaint)
"h" = (
/obj/machinery/portable_atmospherics/hydroponics,
/turf/simulated/floor/asteroid/grass,
/area/deepmaint)
"i" = (
/obj/structure/table/woodentable,
/obj/random/pack/rare,
/obj/random/pack/gun_loot/low_chance,
/obj/random/pack/gun_loot/low_chance,
/obj/random/pack/gun_loot/low_chance,
/obj/random/gun_shotgun/low_chance,
/turf/simulated/floor/asteroid/grass,
/area/deepmaint)
"j" = (
/obj/structure/table/woodentable,
/obj/random/pack/rare/low_chance,
/obj/random/pack/rare/low_chance,
/obj/random/firstaid/low_chance,
/turf/simulated/floor/asteroid/dirt,
/area/deepmaint)
"k" = (
/turf/simulated/floor/asteroid/dirt,
/area/deepmaint)
"l" = (
/obj/random/mob/psi_monster/low_chance,
/turf/simulated/floor/asteroid/grass,
/area/deepmaint)
"m" = (
/turf/simulated/floor/wood,
/area/deepmaint)
"n" = (
/turf/simulated/floor/tiled/steel/cargo,
/area/deepmaint)
"o" = (
/obj/machinery/door/airlock/glass{
	name = "Hydroponics";
	req_access = list(35)
	},
/turf/simulated/floor/wood,
/area/deepmaint)
"p" = (
/turf/simulated/floor/tiled/steel/panels,
/area/deepmaint)
"q" = (
/obj/random/traps/low_chance,
/turf/simulated/floor/tiled/steel/panels,
/area/deepmaint)
"r" = (
/obj/structure/table/woodentable,
/obj/random/pack/tech_loot,
/obj/random/pack/tech_loot,
/obj/random/pack/tech_loot/low_chance,
/obj/random/pack/tech_loot/low_chance,
/obj/random/tool_upgrade/rare/low_chance,
/turf/simulated/floor/asteroid/grass,
/area/deepmaint)
"t" = (
/obj/machinery/light/small,
/turf/simulated/floor/wood,
/area/deepmaint)
"u" = (
/obj/machinery/light/small{
	dir = 1
	},
/turf/simulated/floor/wood,
/area/deepmaint)
"F" = (
/obj/random/mob/psi_monster/low_chance,
/turf/simulated/floor/wood,
/area/deepmaint)
"I" = (
/obj/random/mob/psi_monster/low_chance,
/turf/simulated/floor/tiled/steel/brown_platform,
/area/deepmaint)
"N" = (
/obj/random/cluster/psi_monster/low_chance,
/turf/simulated/floor/tiled/steel/brown_platform,
/area/deepmaint)
"Q" = (
/obj/random/mob/psi_monster/low_chance,
/turf/simulated/floor/tiled/steel/cargo,
/area/deepmaint)
"S" = (
/obj/random/mob/psi_monster/low_chance,
/turf/simulated/floor/asteroid/dirt,
/area/deepmaint)

(1,1,1) = {"
a
a
a
N
n
n
n
a
a
a
I
"}
(2,1,1) = {"
a
b
c
c
b
p
b
c
c
b
a
"}
(3,1,1) = {"
a
c
e
S
c
q
c
r
r
c
a
"}
(4,1,1) = {"
a
c
f
k
c
p
c
S
r
c
a
"}
(5,1,1) = {"
I
c
g
t
b
q
b
u
h
c
I
"}
(6,1,1) = {"
a
c
g
m
o
p
o
F
h
c
a
"}
(7,1,1) = {"
a
c
h
t
b
q
b
u
h
c
a
"}
(8,1,1) = {"
a
c
i
l
c
p
c
k
r
c
a
"}
(9,1,1) = {"
a
c
j
k
c
p
c
r
r
c
a
"}
(10,1,1) = {"
a
b
c
c
b
q
b
c
c
b
I
"}
(11,1,1) = {"
a
I
a
a
Q
n
n
N
a
a
a
"}
