//MAP CONVERTED BY dmm2tgm.py THIS HEADER COMMENT PREVENTS RECONVERSION, DO NOT REMOVE
"a" = (
/turf/simulated/floor/tiled/white/brown_platform,
/area/deepmaint)
"b" = (
/obj/structure/table/standard,
/obj/random/medical,
/obj/random/medical,
/obj/random/medical,
/obj/random/medical/low_chance,
/obj/random/medical/low_chance,
/obj/random/medical/low_chance,
/turf/simulated/floor/tiled/white/brown_perforated,
/area/deepmaint)
"c" = (
/obj/structure/closet/crate/freezer,
/obj/random/pack/rare/low_chance,
/turf/simulated/floor/tiled/white/brown_perforated,
/area/deepmaint)
"d" = (
/obj/structure/table/standard,
/obj/random/surgery_tool,
/obj/random/surgery_tool/low_chance,
/turf/simulated/floor/tiled/white/brown_perforated,
/area/deepmaint)
"e" = (
/obj/structure/table/standard,
/obj/random/lowkeyrandom,
/obj/random/lowkeyrandom,
/turf/simulated/floor/tiled/white/brown_perforated,
/area/deepmaint)
"f" = (
/obj/random/medical_lowcost,
/turf/simulated/floor/tiled/white/brown_platform,
/area/deepmaint)
"g" = (
/obj/random/medical/low_chance,
/turf/simulated/floor/tiled/white/brown_platform,
/area/deepmaint)
"h" = (
/turf/simulated/wall,
/area/deepmaint)
"i" = (
/obj/effect/window_lwall_spawn/smartspawn,
/turf/simulated/floor/plating,
/area/deepmaint)
"j" = (
/obj/random/cluster/psi_monster,
/turf/simulated/floor/tiled/white/brown_platform,
/area/deepmaint)
"k" = (
/obj/structure/table/standard,
/obj/random/surgery_tool,
/obj/random/surgery_tool/low_chance,
/obj/item/tool/medmultitool,
/turf/simulated/floor/tiled/white/panels,
/area/deepmaint)
"l" = (
/obj/machinery/optable,
/turf/simulated/floor/tiled/white/panels,
/area/deepmaint)
"m" = (
/turf/simulated/floor/tiled/white/panels,
/area/deepmaint)
"o" = (
/turf/simulated/floor/tiled/steel/techfloor_grid,
/area/deepmaint)
"p" = (
/obj/structure/table/standard,
/obj/random/contraband/low_chance,
/obj/random/contraband/low_chance,
/turf/simulated/floor/tiled/white/brown_perforated,
/area/deepmaint)
"q" = (
/obj/structure/medical_stand,
/turf/simulated/floor/tiled/white/brown_perforated,
/area/deepmaint)
"r" = (
/turf/simulated/floor/tiled/white/brown_perforated,
/area/deepmaint)
"s" = (
/obj/machinery/light/small{
	dir = 1
	},
/turf/simulated/floor/tiled/white/brown_platform,
/area/deepmaint)
"v" = (
/obj/random/mob/psi_monster/low_chance,
/turf/simulated/floor/tiled/white/panels,
/area/deepmaint)
"C" = (
/obj/random/cluster/psi_monster/low_chance,
/turf/simulated/floor/tiled/white/brown_platform,
/area/deepmaint)
"I" = (
/obj/structure/table/standard,
/obj/random/surgery_tool,
/obj/random/surgery_tool/low_chance,
/obj/random/pouch/low_chance,
/turf/simulated/floor/tiled/white/panels,
/area/deepmaint)
"O" = (
/obj/structure/table/standard,
/obj/random/dungeon_gun_ballistic/low_chance,
/obj/random/pouch/low_chance,
/turf/simulated/floor/tiled/white/brown_perforated,
/area/deepmaint)
"Q" = (
/obj/random/mob/psi_monster/low_chance,
/turf/simulated/floor/tiled/white/brown_platform,
/area/deepmaint)

(1,1,1) = {"
a
a
a
a
a
a
Q
a
a
a
a
"}
(2,1,1) = {"
Q
h
h
a
a
h
h
h
h
p
a
"}
(3,1,1) = {"
a
b
i
f
f
i
k
m
h
q
a
"}
(4,1,1) = {"
a
b
i
g
a
i
l
v
o
r
a
"}
(5,1,1) = {"
a
b
i
a
a
i
i
i
h
s
a
"}
(6,1,1) = {"
a
c
i
j
a
a
a
a
a
C
a
"}
(7,1,1) = {"
a
d
i
a
a
i
i
i
h
s
a
"}
(8,1,1) = {"
a
e
i
a
a
i
l
m
o
r
a
"}
(9,1,1) = {"
a
e
i
a
a
i
I
v
h
q
a
"}
(10,1,1) = {"
Q
h
h
a
a
h
h
h
h
O
a
"}
(11,1,1) = {"
a
a
a
a
a
a
Q
a
a
a
a
"}
