//MAP CONVERTED BY dmm2tgm.py THIS HEADER COMMENT PREVENTS RECONVERSION, DO NOT REMOVE
"a" = (
/turf/simulated/floor/tiled/dark,
/area/deepmaint)
"b" = (
/obj/machinery/light/small,
/turf/simulated/floor/tiled/dark,
/area/deepmaint)
"c" = (
/turf/simulated/wall,
/area/deepmaint)
"d" = (
/obj/structure/table/rack,
/obj/random/pack/tech_loot/low_chance,
/obj/random/pack/tech_loot/low_chance,
/obj/random/pack/tech_loot/low_chance,
/obj/random/pack/tech_loot/low_chance,
/obj/random/common_oddities/low_chance,
/turf/simulated/floor/tiled/dark/gray_perforated,
/area/deepmaint)
"e" = (
/obj/structure/table/rack,
/obj/random/pack/gun_loot/low_chance,
/obj/random/pack/gun_loot/low_chance,
/obj/random/common_oddities/low_chance,
/turf/simulated/floor/tiled/dark/gray_perforated,
/area/deepmaint)
"f" = (
/obj/structure/table/rack/shelf,
/obj/random/pack/cloth,
/obj/random/pack/cloth,
/obj/random/pack/cloth,
/obj/random/pack/cloth/low_chance,
/obj/random/pack/cloth/low_chance,
/obj/random/lathe_disk/advanced/low_chance,
/turf/simulated/floor/tiled/dark/gray_perforated,
/area/deepmaint)
"g" = (
/turf/simulated/floor/tiled/dark/techfloor_grid,
/area/deepmaint)
"h" = (
/obj/machinery/door/firedoor,
/obj/effect/window_lwall_spawn/smartspawn,
/turf/simulated/floor/plating,
/area/deepmaint)
"i" = (
/obj/machinery/light/small{
	dir = 1
	},
/turf/simulated/floor/tiled/dark/panels,
/area/deepmaint)
"j" = (
/obj/structure/morgue{
	dir = 8;
	icon_state = "morgue1"
	},
/turf/simulated/floor/tiled/dark/panels,
/area/deepmaint)
"k" = (
/turf/simulated/floor/tiled/dark/panels,
/area/deepmaint)
"l" = (
/obj/machinery/light/small{
	dir = 8
	},
/turf/simulated/floor/tiled/dark,
/area/deepmaint)
"m" = (
/obj/structure/table/standard,
/obj/item/autopsy_scanner{
	pixel_x = 1;
	pixel_y = 1
	},
/obj/item/tool/scalpel,
/obj/item/tool/cautery{
	pixel_y = 4
	},
/obj/item/storage/firstaid/surgery/traitor,
/turf/simulated/floor/tiled/dark/panels,
/area/deepmaint)
"n" = (
/obj/machinery/optable,
/turf/simulated/floor/tiled/dark/panels,
/area/deepmaint)
"o" = (
/obj/machinery/light/small{
	dir = 4;
	pixel_y = 0
	},
/turf/simulated/floor/tiled/dark,
/area/deepmaint)
"p" = (
/obj/machinery/door/airlock/maintenance_common{
	name = "Service Maintenance";
	req_access = list(12)
	},
/turf/simulated/floor/tiled/dark/cargo,
/area/deepmaint)
"q" = (
/obj/machinery/bodyscanner,
/turf/simulated/floor/tiled/dark/panels,
/area/deepmaint)
"r" = (
/obj/machinery/body_scanconsole,
/turf/simulated/floor/tiled/dark/panels,
/area/deepmaint)
"s" = (
/obj/structure/table/rack,
/obj/random/medical,
/obj/random/medical/low_chance,
/obj/random/medical/low_chance,
/turf/simulated/floor/tiled/dark/gray_perforated,
/area/deepmaint)
"t" = (
/obj/machinery/light/small{
	dir = 1
	},
/turf/simulated/floor/tiled/dark,
/area/deepmaint)
"v" = (
/obj/random/mob/psi_monster/low_chance,
/turf/simulated/floor/tiled/dark,
/area/deepmaint)
"z" = (
/obj/random/mob/psi_monster/low_chance,
/turf/simulated/floor/tiled/dark/panels,
/area/deepmaint)
"E" = (
/obj/structure/table/standard,
/obj/random/card_carp,
/obj/random/card_carp,
/obj/random/card_carp,
/obj/random/card_carp/pelt,
/turf/simulated/floor/tiled/dark,
/area/deepmaint)
"L" = (
/obj/machinery/light/small,
/obj/random/mob/psi_monster/low_chance,
/turf/simulated/floor/tiled/dark,
/area/deepmaint)
"S" = (
/obj/structure/table/rack,
/obj/random/medical,
/obj/random/medical/low_chance,
/obj/random/medical/low_chance,
/obj/random/firstaid/low_chance,
/turf/simulated/floor/tiled/dark/gray_perforated,
/area/deepmaint)
"U" = (
/obj/random/mob/psi_monster/low_chance,
/turf/simulated/floor/tiled/dark/techfloor_grid,
/area/deepmaint)
"Z" = (
/obj/structure/table/rack/shelf,
/obj/random/pack/cloth,
/obj/random/pack/cloth,
/obj/random/pack/cloth,
/obj/random/pack/cloth/low_chance,
/obj/random/pack/cloth/low_chance,
/obj/random/lathe_disk/advanced/low_chance,
/obj/random/lathe_disk/advanced/low_chance,
/turf/simulated/floor/tiled/dark/gray_perforated,
/area/deepmaint)

(1,1,1) = {"
a
a
a
v
a
a
a
a
a
v
a
"}
(2,1,1) = {"
L
c
c
a
a
c
c
c
c
c
t
"}
(3,1,1) = {"
a
c
f
g
U
h
m
k
q
c
a
"}
(4,1,1) = {"
a
c
Z
g
g
h
n
z
r
c
a
"}
(5,1,1) = {"
b
c
c
E
a
c
c
p
c
c
t
"}
(6,1,1) = {"
a
v
a
a
a
a
o
a
a
a
v
"}
(7,1,1) = {"
a
d
c
h
h
h
c
p
c
S
a
"}
(8,1,1) = {"
a
d
c
i
k
k
k
k
c
S
a
"}
(9,1,1) = {"
a
e
c
j
j
j
j
j
c
s
a
"}
(10,1,1) = {"
v
e
c
c
c
c
c
c
c
s
a
"}
(11,1,1) = {"
a
a
v
a
a
l
a
v
a
a
a
"}
