//MAP CONVERTED BY dmm2tgm.py THIS HEADER COMMENT PREVENTS RECONVERSION, DO NOT REMOVE
"a" = (
/turf/simulated/floor/tiled/techmaint_panels,
/area/deepmaint)
"b" = (
/turf/simulated/floor/tiled/techmaint_perforated,
/area/deepmaint)
"c" = (
/turf/simulated/wall,
/area/deepmaint)
"d" = (
/obj/random/cluster/psi_monster/low_chance,
/turf/simulated/floor/plating/under,
/area/deepmaint)
"e" = (
/obj/random/scrap/moderate_weighted,
/turf/simulated/floor/plating/under,
/area/deepmaint)
"f" = (
/turf/simulated/floor/plating/under,
/area/deepmaint)
"g" = (
/obj/random/pack/machine,
/turf/simulated/floor/tiled/techmaint_cargo,
/area/deepmaint)
"h" = (
/obj/effect/window_lwall_spawn/smartspawn,
/turf/simulated/floor/plating,
/area/deepmaint)
"i" = (
/obj/structure/table/standard,
/obj/random/pack/tech_loot,
/obj/random/pack/tech_loot,
/obj/random/pack/tech_loot,
/obj/random/pack/tech_loot,
/obj/random/pack/tech_loot/low_chance,
/obj/random/pack/tech_loot/low_chance,
/obj/random/common_oddities,
/obj/random/lathe_disk/advanced,
/turf/simulated/floor/tiled/white/brown_perforated,
/area/deepmaint)
"j" = (
/turf/simulated/floor/tiled/techmaint_cargo,
/area/deepmaint)
"k" = (
/obj/structure/table/standard,
/obj/random/pack/rare,
/obj/random/pack/rare,
/obj/random/pack/rare,
/obj/random/pack/rare/low_chance,
/obj/random/lathe_disk/advanced/onestar,
/obj/random/dungeon_gun_mods,
/obj/random/dungeon_gun_mods,
/turf/simulated/floor/tiled/white/brown_perforated,
/area/deepmaint)
"l" = (
/obj/random/mob/psi_monster/low_chance,
/turf/simulated/floor/tiled/techmaint_cargo,
/area/deepmaint)
"m" = (
/obj/structure/table/standard,
/obj/random/pack/gun_loot,
/obj/random/pack/gun_loot/low_chance,
/obj/random/pack/gun_loot/low_chance,
/obj/random/pack/gun_loot/low_chance,
/obj/random/psi_megafauna,
/turf/simulated/floor/tiled/white/brown_perforated,
/area/deepmaint)
"o" = (
/obj/random/mob/psi_monster/low_chance,
/turf/simulated/floor/plating/under,
/area/deepmaint)
"q" = (
/obj/machinery/door/airlock/maintenance_common{
	name = "Service Maintenance";
	req_access = list(12)
	},
/turf/simulated/floor/tiled/techmaint_cargo,
/area/deepmaint)
"r" = (
/obj/random/mob/psi_monster/low_chance,
/turf/simulated/floor/tiled/techmaint_perforated,
/area/deepmaint)
"t" = (
/obj/random/cluster/psi_monster,
/turf/simulated/floor/tiled/techmaint_cargo,
/area/deepmaint)
"v" = (
/obj/structure/table/standard,
/obj/random/pack/tech_loot,
/obj/random/pack/tech_loot,
/obj/random/pack/tech_loot,
/obj/random/pack/tech_loot,
/obj/random/pack/tech_loot/low_chance,
/obj/random/pack/tech_loot/low_chance,
/obj/machinery/light/small{
	dir = 1
	},
/obj/random/common_oddities,
/obj/random/lathe_disk/advanced,
/turf/simulated/floor/tiled/white/brown_perforated,
/area/deepmaint)
"w" = (
/obj/machinery/light/small{
	dir = 1
	},
/turf/simulated/floor/tiled/techmaint_panels,
/area/deepmaint)
"O" = (
/obj/random/cluster/psi_monster/lower_chance,
/turf/simulated/floor/tiled/techmaint_perforated,
/area/deepmaint)

(1,1,1) = {"
b
b
b
b
b
b
b
b
b
O
b
"}
(2,1,1) = {"
b
c
c
c
c
c
f
f
a
j
b
"}
(3,1,1) = {"
r
c
d
f
f
o
f
f
a
j
b
"}
(4,1,1) = {"
b
c
e
e
c
h
h
c
w
j
r
"}
(5,1,1) = {"
b
c
c
c
c
v
i
h
a
j
r
"}
(6,1,1) = {"
b
a
o
c
g
l
j
q
t
j
r
"}
(7,1,1) = {"
b
c
c
c
c
k
m
h
a
j
r
"}
(8,1,1) = {"
b
c
e
e
c
h
h
c
a
j
r
"}
(9,1,1) = {"
b
c
d
f
f
o
f
f
a
j
b
"}
(10,1,1) = {"
r
c
c
c
c
c
f
f
a
j
b
"}
(11,1,1) = {"
b
b
b
b
b
b
b
b
b
O
b
"}
