//MAP CONVERTED BY dmm2tgm.py THIS HEADER COMMENT PREVENTS RECONVERSION, DO NOT REMOVE
"a" = (
/turf/simulated/floor/tiled/steel/brown_perforated,
/area/deepmaint)
"b" = (
/turf/simulated/wall,
/area/deepmaint)
"c" = (
/turf/simulated/floor/tiled/steel/monofloor,
/area/deepmaint)
"d" = (
/obj/structure/table/rack/shelf,
/obj/random/pack/cloth,
/obj/random/pack/cloth,
/obj/random/pack/cloth,
/obj/random/pack/cloth/low_chance,
/obj/random/pack/cloth/low_chance,
/obj/random/pack/cloth/low_chance,
/turf/simulated/floor/tiled/steel/techfloor,
/area/deepmaint)
"e" = (
/obj/structure/table/rack/shelf,
/obj/random/medical/low_chance,
/obj/random/medical/low_chance,
/obj/random/medical/low_chance,
/obj/random/medical/low_chance,
/obj/random/medical/low_chance,
/turf/simulated/floor/tiled/steel/techfloor,
/area/deepmaint)
"f" = (
/turf/simulated/floor/tiled/steel/techfloor,
/area/deepmaint)
"g" = (
/obj/machinery/door/airlock/maintenance_common{
	name = "Service Maintenance";
	req_access = list(12)
	},
/turf/simulated/floor/tiled/steel/cargo,
/area/deepmaint)
"h" = (
/obj/structure/table/rack/shelf,
/obj/random/pack/tech_loot/low_chance,
/obj/random/pack/tech_loot/low_chance,
/obj/random/pack/tech_loot/low_chance,
/obj/random/pack/tech_loot/low_chance,
/obj/random/pack/tech_loot/low_chance,
/obj/random/pack/tech_loot/low_chance,
/turf/simulated/floor/tiled/steel/techfloor,
/area/deepmaint)
"i" = (
/obj/structure/table/rack/shelf,
/obj/random/pack/gun_loot,
/obj/random/pack/gun_loot,
/obj/random/pack/gun_loot/low_chance,
/obj/random/pack/gun_loot/low_chance,
/obj/random/pack/gun_loot/low_chance,
/obj/random/dungeon_gun_ballistic/low_chance,
/turf/simulated/floor/tiled/steel/techfloor,
/area/deepmaint)
"j" = (
/obj/structure/table/rack/shelf,
/obj/random/pack/rare/low_chance,
/obj/random/common_oddities/low_chance,
/obj/random/powercell/low_chance,
/obj/random/lathe_disk/advanced/low_chance,
/obj/random/tool_upgrade/low_chance,
/turf/simulated/floor/tiled/steel/brown_platform,
/area/deepmaint)
"k" = (
/obj/random/cluster/psi_monster/low_chance,
/turf/simulated/floor/tiled/steel/panels,
/area/deepmaint)
"l" = (
/turf/simulated/floor/tiled/steel/panels,
/area/deepmaint)
"m" = (
/obj/machinery/light/small,
/turf/simulated/floor/tiled/steel/brown_perforated,
/area/deepmaint)
"n" = (
/obj/machinery/light/small,
/obj/random/mob/psi_monster/low_chance,
/turf/simulated/floor/tiled/steel/techfloor,
/area/deepmaint)
"o" = (
/obj/machinery/light/small{
	dir = 1
	},
/turf/simulated/floor/tiled/steel/panels,
/area/deepmaint)
"p" = (
/obj/random/mob/psi_monster/low_chance,
/turf/simulated/floor/tiled/steel/brown_perforated,
/area/deepmaint)
"A" = (
/obj/structure/table/rack/shelf,
/obj/random/pack/rare/low_chance,
/obj/random/common_oddities/low_chance,
/obj/random/powercell/low_chance,
/obj/random/lathe_disk/advanced/low_chance,
/obj/random/pouch/low_chance,
/obj/random/tool_upgrade/rare/low_chance,
/turf/simulated/floor/tiled/steel/brown_platform,
/area/deepmaint)
"F" = (
/obj/random/mob/psi_monster/low_chance,
/turf/simulated/floor/tiled/steel/monofloor,
/area/deepmaint)
"L" = (
/obj/structure/table/rack/shelf,
/obj/random/pack/gun_loot,
/obj/random/pack/gun_loot,
/obj/random/pack/gun_loot/low_chance,
/obj/random/pack/gun_loot/low_chance,
/obj/random/pack/gun_loot/low_chance,
/obj/random/dungeon_gun_energy/low_chance,
/turf/simulated/floor/tiled/steel/techfloor,
/area/deepmaint)
"O" = (
/obj/structure/table/rack/shelf,
/obj/random/pack/rare/low_chance,
/obj/random/common_oddities/low_chance,
/obj/random/powercell/low_chance,
/obj/random/lathe_disk/advanced/low_chance,
/obj/random/techpart/low_chance,
/turf/simulated/floor/tiled/steel/brown_platform,
/area/deepmaint)

(1,1,1) = {"
a
p
a
a
a
p
a
a
a
a
a
"}
(2,1,1) = {"
a
b
b
b
b
b
b
b
b
k
a
"}
(3,1,1) = {"
a
b
d
f
b
h
f
b
j
l
a
"}
(4,1,1) = {"
a
b
d
n
b
h
n
b
A
l
a
"}
(5,1,1) = {"
m
b
b
g
b
b
g
b
b
o
a
"}
(6,1,1) = {"
a
F
c
F
c
c
F
c
c
F
a
"}
(7,1,1) = {"
a
b
b
g
b
b
g
b
b
l
a
"}
(8,1,1) = {"
a
b
e
n
b
i
n
b
O
l
a
"}
(9,1,1) = {"
a
b
e
f
b
L
f
b
O
l
a
"}
(10,1,1) = {"
a
b
b
b
b
b
b
b
b
k
a
"}
(11,1,1) = {"
a
p
a
a
a
p
a
a
a
a
a
"}
