"a" = (/turf/simulated/floor/tiled/steel/brown_perforated,/area/deepmaint)
"b" = (/turf/simulated/wall,/area/deepmaint)
"c" = (/turf/simulated/floor/tiled/steel/monofloor,/area/deepmaint)
"d" = (/obj/structure/table/rack/shelf,/obj/random/pack/cloth,/obj/random/pack/cloth,/obj/random/pack/cloth,/obj/random/pack/cloth/low_chance,/obj/random/pack/cloth/low_chance,/obj/random/pack/cloth/low_chance,/turf/simulated/floor/tiled/steel/techfloor,/area/deepmaint)
"e" = (/obj/structure/table/rack/shelf,/obj/random/medical/low_chance,/obj/random/medical/low_chance,/obj/random/medical/low_chance,/obj/random/medical/low_chance,/obj/random/medical/low_chance,/turf/simulated/floor/tiled/steel/techfloor,/area/deepmaint)
"f" = (/turf/simulated/floor/tiled/steel/techfloor,/area/deepmaint)
"g" = (/obj/machinery/door/airlock/maintenance_common{name = "Service Maintenance"; req_access = list(12)},/turf/simulated/floor/tiled/steel/cargo,/area/deepmaint)
"h" = (/obj/structure/table/rack/shelf,/obj/random/pack/tech_loot/low_chance,/obj/random/pack/tech_loot/low_chance,/obj/random/pack/tech_loot/low_chance,/obj/random/pack/tech_loot/low_chance,/obj/random/pack/tech_loot/low_chance,/obj/random/pack/tech_loot/low_chance,/turf/simulated/floor/tiled/steel/techfloor,/area/deepmaint)
"i" = (/obj/structure/table/rack/shelf,/obj/random/pack/gun_loot,/obj/random/pack/gun_loot,/obj/random/pack/gun_loot/low_chance,/obj/random/pack/gun_loot/low_chance,/obj/random/pack/gun_loot/low_chance,/obj/random/dungeon_gun_ballistic/low_chance,/turf/simulated/floor/tiled/steel/techfloor,/area/deepmaint)
"j" = (/obj/structure/table/rack/shelf,/obj/random/pack/gun_loot,/obj/random/pack/gun_loot,/obj/random/pack/gun_loot/low_chance,/obj/random/pack/gun_loot/low_chance,/obj/random/pack/gun_loot/low_chance,/obj/random/dungeon_gun_energy/low_chance,/turf/simulated/floor/tiled/steel/techfloor,/area/deepmaint)
"k" = (/obj/structure/table/rack/shelf,/obj/random/pack/rare/low_chance,/obj/random/common_oddities/low_chance,/obj/random/powercell/low_chance,/obj/random/lathe_disk/advanced/low_chance,/obj/random/tool_upgrade/low_chance,/turf/simulated/floor/tiled/steel/brown_platform,/area/deepmaint)
"l" = (/turf/simulated/floor/tiled/steel/panels,/area/deepmaint)
"m" = (/obj/machinery/light/small,/turf/simulated/floor/tiled/steel/brown_perforated,/area/deepmaint)
"n" = (/obj/machinery/light/small,/turf/simulated/floor/tiled/steel/techfloor,/area/deepmaint)
"o" = (/obj/machinery/light/small{dir = 1},/turf/simulated/floor/tiled/steel/panels,/area/deepmaint)
"p" = (/obj/structure/table/rack/shelf,/obj/random/pack/rare/low_chance,/obj/random/common_oddities/low_chance,/obj/random/powercell/low_chance,/obj/random/lathe_disk/advanced/low_chance,/obj/random/pouch/low_chance,/obj/random/tool_upgrade/rare/low_chance,/turf/simulated/floor/tiled/steel/brown_platform,/area/deepmaint)
"q" = (/obj/structure/table/rack/shelf,/obj/random/pack/rare/low_chance,/obj/random/common_oddities/low_chance,/obj/random/powercell/low_chance,/obj/random/lathe_disk/advanced/low_chance,/obj/random/techpart/low_chance,/turf/simulated/floor/tiled/steel/brown_platform,/area/deepmaint)
"r" = (/obj/random/cluster/psi_monster/low_chance,/turf/simulated/floor/tiled/steel/panels,/area/deepmaint)

(1,1,1) = {"
aaaamaaaaaa
abbbbcbbbba
abddbcbeeba
abfngcgnfba
abbbbcbbbba
abhhbcbijba
abfngcgnfba
abbbbcbbbba
abkpbcbqqba
arlloclllra
aaaaaaaaaaa
"}
