"a" = (/obj/structure/snowfall,/turf/simulated/floor/asteroid/shale,/area/nadezhda/outside/kepler)
"d" = (/turf/simulated/floor/fixed/shale/dark,/area/nadezhda/outside/kepler)
"g" = (/obj/structure/snowfall,/turf/simulated/floor/fixed/shale/rock{dir = 8},/area/nadezhda/outside/kepler)
"k" = (/obj/structure/snowfall,/obj/structure/light_stick/red,/turf/simulated/floor/asteroid/shale,/area/nadezhda/outside/kepler)
"m" = (/obj/structure/snowfall,/turf/unsimulated/mineral/cold,/area/nadezhda/outside/kepler)
"p" = (/turf/unsimulated/mineral/cold,/area/nadezhda/outside/kepler)
"r" = (/obj/structure/light_stick/red,/turf/simulated/floor/asteroid/shale,/area/nadezhda/outside/kepler/red)
"t" = (/turf/simulated/floor/asteroid/shale,/area/nadezhda/outside/kepler/red)
"u" = (/obj/structure/snowfall,/turf/simulated/floor/fixed/shale/rock{dir = 3},/area/nadezhda/outside/kepler)
"v" = (/obj/structure/snowfall,/obj/structure/snowfall,/turf/simulated/floor/fixed/shale/windswept,/area/nadezhda/outside/kepler)
"w" = (/obj/structure/snowfall,/obj/structure/light_stick/red,/turf/simulated/floor/fixed/shale/dark,/area/nadezhda/outside/kepler)
"A" = (/obj/structure/snowfall,/turf/simulated/floor/fixed/shale/rock{dir = 5},/area/nadezhda/outside/kepler)
"B" = (/obj/structure/snowfall,/turf/simulated/floor/fixed/shale/rock{dir = 6},/area/nadezhda/outside/kepler)
"L" = (/obj/structure/snowfall,/turf/simulated/floor/fixed/shale/windswept,/area/nadezhda/outside/kepler)
"N" = (/obj/structure/snowfall,/turf/simulated/floor/fixed/shale/rock{dir = 7},/area/nadezhda/outside/kepler)
"R" = (/obj/structure/snowfall,/turf/simulated/floor/fixed/shale/dark,/area/nadezhda/outside/kepler)

(1,1,1) = {"
pppppppppppppppppppppppppppppppppppppppppppppppppppppppppppppppppppppppppppppppppppppppppppppppppppp
pppppppppppppppppppppppppppppppppppppppppppppppppppppppppppppppppppppppppppppppppppppppppppppppppppp
pppppppppppppppppppppppLLLLLpppppppppppppppppppppppppppppppppppppppppppppppppppppppppLLLpppppppppppp
pppppppppppppppppppLLLLLLLLLLLLLppppppppppppppppppppLLLLpppppLLLLLppppppppppppppppppLvpLLppppppppppp
ppppppppppppppppppLLLLLLLLLLLLLLLLLLLLLLLppppLLLLLLLLLLLLLLLLLLLLLLppppppLLLLLLLppppppppLppppppppppp
pppppppppppppppppLLLLLLLLaaaaaaLLLLLLLLLLLLLLLLLLLLLLLLLLLLLLLLLLLLLLppLLLLLLLLLLLppppppLppppppppppp
ppppppppppppppppLLLLLLLLaaaaaaaaLLLLLLLLLLLLLLLLLLLLLLLLLLLLLLLLLLLLLLLLLLLLpppLLLLppppLLppppppppppp
ppppppppLLLLLpppLLLLLLLaaaLLLLaaLLLLLLLLLLLLLLLLLLLLLLLLLLLLLLLLLLLLLLLLLppppppppLLLLpLLpppppppppppp
ppppppppLLLLLLpppLLLLLLaaLLLLLLaaLLLLLLLLLLLLLLLLLLLLLLLLLLLLLLLLLLpppppppppppppppLpLLLppppppppppppp
pppppppLLLLLLLpppLLLLLLaaLLLLLLLaaaLLLLLLLLLLLLLLLLLLLLLLLLLLLLLLLLLLLpppppppppppppppppppppppppppppp
pppppppLLLLLLLpppLLLLLaaaLLLLLLLLaaaLLLLLLLLLLLLLLLLLLLLLLLLLLLaaaaLLLLLLLppppppppLLLppppppppppppppp
pppppppLLLLLLLLppLLLLLaaaLLLLLLLLLLLaaLLLLLLLLLLLLLLLLLLLLLLLLaaLLaLLLLLLLLLLLLLLLLLLLLppppppppppppp
pppppppLLLLLLLLppLLLLLaaaaLLLLLLLLLLLLaaLLLLLLLLLLLLLLLLLLLLLLaLLLaaLLLLLLLLLLLLLLLLLLLLLLpppppppppp
pppppppLLLLLLppppLLLLLLaaaaaaaLLLLLLLLLLLLLLLLLLLLLLLaaaLLLLLLaaLLLaLLLLLLLLLLLLLLLLLLLLLLLLpppppppp
pppppppLLLLLpppLLLLLLLLaaaaaaaaaaaLLLLLLLLLLLaaaaaaaaLLLaLLLLLLaaLLaaLLLLLLLLLLLLLLLLLLLLLLLpppppppp
ppppppppLLLppLLLLaLLLLLLaaaaaaaaaaaaaaLLLLLaaaaaaLLLLLLLLLLLLLLLLLLLaLLLLLLLLLLLLLLLLLLLLLLLLppppppp
pppppppppLLppLLLaaaaLLLLaaaaaaaaaaaaaaaaaaaaaaLLLLLLLLLLLLLLLLLLLLLLaLLLLLLLLLLLLLLLLLLLLLLLLppppppp
pppppppppLLpLLLLaaaaaLLLaaaaaaaaaaaaaaaaaaaaaLLLLLLLLLLLLLLLLLLLLLLaaLLLLLLLLLLLLLLLLLLLLLLLLLpppppp
pppppppppLLpLLLLaaaaaaLLLaaaaaaaaaaaaaaaaaaaaLLaaaaaaaaaaaaaaaaaaaaaaLLLLLLLLLLLLLLLLLLLLLLLLLLppppp
pppppppppLLppLLLaaaaaaaLLLaaaaaaaaaaaaaaaaaaaLLaaaaaaaaaaAaaaaaaaaaaaaLLLLLLLLLLLLaaaaaaaLLLLLLLpppp
pppppppppLLLLLLLaaaaaaaaLLLaaaaaaaaaaaaaaaaaaLLaaaaaaaaaaaaaaaaaaaaaaaaLLLLLLLLLLaaaaaLaaaLLLLLLpppp
pppppppppLLLLLLLLaaaaaaaaLLLLLaaaaaaaaaaaaaaaaLLLaaaaaaLaaaaaaaLLLLaaaaaaaLLLLLLaaaaLLLLaaLLLLLLpppp
pppppppppLLLLLLLLaaaaaaaaaaaaaLLLLaaaaaaaaaaaaLLLLLLLLLLaaaaLLLLaaaLLLaaaaaaLLLLaaaLLLLLLaLLLLLLpppp
pppppLLLpLLLLLLLLLaaaaaaaaaaaaaaaaaaaAaaaaaaaaaaLLLLLaaaaaaaaaaaaaaaLLLLLLaaLLLLaaaLLLLLLaaLLLLLpppp
ppppLLpppLLLLLLLLLaaaaaaaaaaaaaaaaaaaaaaaaaaaaaaaaaaaaaaaaaaaaaaaaaaaLLLLLLLLLLLaaLLLLLLLLaLLLLLpppp
pppLLppppLLLLLLLLLLaaaaaaaaaaaaaaaaaaaaaaaaaaaaaaaaaaaaaaaaaaaaaaaaaaaaaaLLLLLLaaaLLaLLLLaaLLLLLpppp
ppLLpppppLLLLLLLLLLLLLLaaaaaaaaaaaaaaaaaaaaaaaaaaaaaaaaaaaaaaaaaaaaaaaaaaaaaaaaaaaLLaLLLLaLLLLLLpppp
ppLLpppppLLLLLLLLLLaLLLLLaaaaaaaaaaaaaaaaaaaaaaaaaaaaaaaaaaaaaaaaaaaaaaaaaaaaaaaaaLLLaaaaLLLLLLLpppp
ppLLpppppLLLLLLLLLLaaaaLLLaaaaaaaaaaaaaaaaaaaaaaaaaaaaaaaaaaaaaaaaaaaaaaaaaaaaaaaaLLLLLLLLLLLLLLpppp
pppLLppppLLLLLLLLLLaaaaLLLLaaaaaaaaaaaaaaaaaaaaaaaaaaaaaaaaaaaaaaaaaaaaaaaaaaaaaaaLLLLLLLLLLLLLLpppp
pppLLLpppLLLLLLLLLLLaaaaLLLLaaaaaaaaaaaaaaaaaaaaaaaaaaaaaaaaaaaaaaaaaaaaaaaaaaaaLaaLLLLLLLLLLLLLpppp
ppppLLLpppLLLLLLLLLLLaaaaLaLaaaaaaaaaaaaaaaaaaaaaaaaaaaaaaaaaaaaaaaaaaaAaaaaaaaaLaaLLLLLLLLLLLLppppp
pppppLLpppLLLLLLLLLLLLaaaaLLLaaaaaaaaaaaaaaaaaaaaaaaaaaaaaaaaaaaaaaaaaaaaaaaaaaaLaaLLLLLLLLLLLLppppp
pppppLLLppLLLLLLLLLLLLLLLaaaLaaaaaaaaaNaaaaaaaaaaaaaaaaaaaaaaaaaaaaaaaaaaaaaaaaaaLLaLLLLLLLLLLLppppp
pppppLLLpppLLLLLLLLLLLLLLLaLLaaaaaaaaaaaaaaaaaaaaaaaaaaaaaaaaaaaaaaaaaaaaaaaaaaaaaaaLLLLLLLLLLLppppp
pppppLLLLpppLLLLLLLLLLLLLLaaLaaaaaaaaaaaaaaaaaaaaaaaaaaaaaaaaaaaaaaaaaaaaaaaaaaaaLaaaLLLLLLLLLpppppp
pppppLLLLpppLLLLLLLLLLLLLLLaLaaaaaaaaaaaaaaatttttttttttttaaaaaaaaaaaaaaaaaaaaaaaaLLaaaLLLLLLLLpppppp
ppppppLLLLppLLLLLLLLLLLLLLLaLLaaaaaaaaaaaaaatttttttttttttaaaaaaaaaaaaaaaaaaaaaaaaLLLaaaaLLLLLppppppp
pppppLLLLLLppLLLLLLLLLLLLLLaLLaaaaaaaaaaaaaatttrttttrttttaaaaaaaaaaaaaaaaaaaaaaaaLLLLaaaaLLLLppppppp
pppppLLLLLLppLLLLLLLLLLLLLLaLLLaaaaaaaaaaaaatttttttttttttaaaaaaaaaaaaaaaaaaaaaaaaLLLLLLLLLLLLppppppp
pppppLLLLLLpLLLLLLLLLLLLLLLaaLLLaaaaaaaaaaaatttttttttttttaaaaaaaaaaaaaaaaaaaaaaaLLLLLLLLLLLLLppppppp
pppppLLLLLLpLLLLLLLLLLLLLLLaaLLLaaaaaaaaaaaatrtttttttttttaaaaaaaaaaaaaaaaaaaaaaaLLLLLLLLLLLLLppppppp
ppppLLLLLLppLLLLLLLLLLLLLLLaaaLLLaaaaaaagaaatttttttttttrtaaaaaaaaaaaaaaaLLaaaaaaLLLLLLLLLLLLLppppppp
ppppLLLLpppLLLLLLLLLLLLLLLaaaaaLLLaaaaaaaaaatttttttttttttaaaaaaaaaaaaaaaLLLLaaaaLLLLLLLLLLLLLppppppp
ppppLLLppLLLLLLLLLLLLLLLLLaaaaaaLLaaaaaaaaaatttttttttttttaaaaaaaaaaaaaaaLLaLLaaLLLLLLLLLLLLLLLpppppp
ppppLLLLLLLLLLLLLLLLLLLLLLaaaaaaaLLLaaaaaaaatttttttttttttaaaaaaaaaaaaaaaaLaaLLaLLLLLLLLLLLLLLLpppppp
ppppLLLLLLLLLLLLLaaaLLLLLLLaaaaaaaLLLaaaaaaatttrttttrttttaaaaaaaaaaaaaaaaLLaaLaLLLLLLLLLLLLLLLLppppp
pppLLLLLLLLLLLLLaaLLLLLLLLLaaaaaaaaaaLaaaaaatttttttttttttaaaaaaaaaaaaaaaaaLLaLaLLLLLLLLLLLLLLLLppppp
pppLLLLLLLLLLLLaaLLLLLLLLLLaaaaaaaaaaaLaaaaaaaaaaaaaaaaaaaaaaaaaaaaaaaaaaaaaaLLLLLLLLLLLLLLLLLLppppp
pppLLLLLLLLLLLLaaLLLLLLLLLLLaaaaaaaaaaaLaaaaaaaaaaaaaaaaaaaaaaaaaaaaaaaNaaaaaaLLLLLLLLLLLLLLLLLLpppp
pppLLLLLLLLLLLLaaLLLLLLLLLLLLaaaaaaaaaaaaaaaaaaaaaaRaaaaaaaaaaaaaaaaaaaaaaaaaLLaaLLLLLLLLLLLLpLLpppp
pppLLLLLLLLLLLLaaLLLLLLLLLLLLaaaaaaaaaaaaaaaaaaaaaaaaRRaaaaaaaaaaaaaaaaaaaaaaLLaLLLLLLLLLLLLLpLLLppp
pppLLLLLLLaLLLLaaLLLLLLLLLLLLLaaaaaaaaaaaaaaaaaaaaaaaaRaaaaaaaaaaaaaaaaaaaaaaLLaaLLLLLLLLLLLLpLLLppp
pppLLLLLLLaLLLLaaLLLLLLLLLLLLLaaaaaaaaaaaaaaaaaakaaaaaaaaaaaaaaaaaaaaaaaaaaaaLLaaLLLLLLLLLLLLppLLppp
pppLLLLLLLaLLLLaaLLLLLLLLLLLLLLaaaaaaaaaaaaaaaaaaaaaaaaaaaaaaaaaaaaaaaaaaaaaaLLaaLLLLLLLLLLLLppLLppp
pppLLLLLLLLaLLLaaLLLLLLLLLLLLLLaaaaaaaaaaaaaaaRaRRaaaaaaaaaaaaaaaaaaaaaaaaaaaaLLaLLLLLLLLLLLLppLLppp
pppLLLLLLLLaLLLaaaLLLLLLLLLLLLLaaaaaaaaaaaaaaaRRRRRRaaaaaaaaaaaaaaaaaaaaaaaaaaLLaLLLLLLLLLLLLppLLppp
pppLLLLLLLLaLLLLaaLLLLLLLLLLLLLaaaaaaaaaaaaaaRaRRaaaaaRRRRaaaaaaaaaaaaaaaaaaaaaLLLLLLLLLLLLLpppLLppp
pppLLLLLLLLLaLLLaaaLLLLLLLLLLLaaaaaaaaaaaaaaaRaRRRRRRRRRRRaaaaaaaaaaaaaaaaaaaaaaLLLLLLLLLLLpppLLpppp
pppLLLLLLLLLLaLLaaaaLLLLLLLLLLaaaaaaaaaaaaaaRRRRRRwRRRRRRRRaaaaaaaaaaaaaaaaaLLLLLLLLLLLLLLLpppLLpppp
pppLLLLLLLLLLLLLLaaaaLLLLLLLLaaaaaaaaagaaaaaRRRRRRRRRRRRRRRRRaaaaaaaaaaaaaaaLLLLLLLLLLLLLLLppLLLpppp
pppLLLLLLLLLLLLaaaaaaaaLLLLLaaaaaaaaaaaaaaaaRRRRRRRRRRRRRRRRRaaaaaaaaaaaaaaaaLLLLLLLLLLLLLLppLLLpppp
pppLLLLLLaLLLLaaaaaaaaaaaaaaaaaaaaaaaaaaaaaRRRRRRRRRRRRRRRRaaaaaaaaaaaaLLaaaaaLLLLLLLLLLLLLppLLppppp
pppLLLLLLLLLLLaaLLaaaaaaaaaaaaaaaaaaaaRRRaaaRRRRRRRRRRRRRRaaaaaaaaaaLLLLLLaaaaaLLLLLLLLLLLLLpLLLpppp
pppLLLLLLLLLLLaLLLLaaaaaaaaaaaaaaaaRRaRRRRRaRRRRRRRRRRRRRRaaaaaaaaaaaaaaLLLLaaaLLLLLLLLLLLLLpLLLpppp
pppLLLLLLaLLLaaLLLLLaaaaaaaaaaaaRRRRRaaaaaaaRRRRRRRRRRRRRRaaBaaaaaaaaaaaaLLLaaaLLLLLLLLLLLLLLLLLpppp
pppLLLLLaLLLLaLLLLLLaaaaaaaaaaaRRRRRRaaaRRRaaRRRRRRRRRRRRRRaaaaLLLaaaaaaaaLLLaaLLLLLLLLLLLLLLLLLpppp
pppLLLLLaLLLLLLLLLLLLaaaaaaaaaaRRRRRaRaRRRRaaRRRRaaaRRRRRaaaaaLLLLLLLaaaaaaLLaaLLLLLLaaaLLLLpLLppppp
pppLLLLLaLLLLLLLLLLLLaaaaaaaaaaRRRRaaaaaaaRRaaRRaaaaaaRRaaaaaLLaaaaLLLaaaaaLLLaaLLLLaaaaaLLLpLLppppp
pppLLLLLLLLLLLLLLLLLLaaaaaaaaaaaaaaaaaaaaaaaaaaaaaaaaaaaaaaLLLaaaaaaLLaaaaaLLLLLLLLLaLLLaaLLpLLppppp
pppLLLLLLLaLLLLLLLLLLaaaaaaaaaaaaaaaaaaaaaaaaaaaakaaaaaaaaaLLaaaaaaaaLaaaaaaLLLLLLLLLLLLaaLLpLLppppp
pppLLLLLLLaLLLLLLLLLLLaaaaaaAaaaaaaaaaaaaaaaaaLLLLaaaaaaaaLLaaaaaaaaaLaaaaaaLLLLLLLLLLLLaaLLppLLpppp
pppLLLLLLLaLLLLLLLLLLLaaaaaaaaaaaaaaaaaaaaaaaLLLLLaaaaaaaLLaaaaaaaaaaaaaaaaaaLLLLLLLLLLLaaLLLpLLpppp
ppppLLLLLLaLLLLLLLLLLLaaaaaaaaaaaaaaaaaaaaaaaLLaaLLaaaaaLLLaaaaaaaaauaaaaaaaaaLLLLLLLLLaaaLLppLLpppp
ppppLLLLLLLaLLLLLLLLLLLaaaaaaaaaaaaaaaaaaaaaLLaaaLLaaaaaLLLaaaaaaaaaaaaaaaaaaaaaaaaaaaaaaLLLppLLpppp
ppppLLLLLLLLLLLLLLLLLLLLaaaaaaaaaaaaaaaLLaaaLLaaaaLaaaaLLLaaaaaaaaaaaaaaaaaAaaaaaaaaaaaaaLLLppLLpppp
pppppLppLLLLLLLLLLLLLLLLaaaaaaaaaaaaaLLLLLLaLLaaaaLaaaaLLLLLLLLLLaaaaaaaaaaaaaaaaaaaaaaaLLLLppLLpppp
pppppLppLLLLLLLLLLLLLLLLLaaaaaaaaaaaLLLLLLLLLLaaaaaaaaaLLLLLLLaaaaaaaaaaaaaaaaaaaaaaaaaLLLLLpLLLpppp
pppppLppLLLLLLLLLLLLLLLLLLaaaaaaaaaaLLLLLLLLLLLaaaaaaaLLLLLLLLaaaaaaaaaaaaaaaaaaaaaaaaLLLLLLLLLLpppp
pppppLppLLLLLLLLLLLLLLLLLLLLaaaaaaaLLLLLLLLLLLLaaaaaaaLLLLLLLLLaaaaaaLLLLLLLLLaaaaaaaLLLLLLLLLLLpppp
ppppLLppLLLLLLLLLLLLLLLLLLLLLaaaaaaLLLLLLLLLLLLakaaaLLLLLLLLLLLaLLLLLLLLLLLLLLLLLLaaLLLLLLLLLLLLpppp
ppppLLLppLLLLLLLLLLLLLLLLLLLLLaaaaaLLLLLLLLLLLLaaaaLLLLLLLLLLLLLLLLLLLLLLLLLLLLLLLLLLLLLLLLLLLLppppp
ppppLLLppLLLpLLLLLLLLLLLLLLLLLLLaaaaLLLLLLLLLLaaaaLLLLLLLLLLLLLLLLaaaaLLLLLLLLLLLLLLLLLLLLLLLLLppppp
ppppLLLpppLLLppLLLLLLLLLLLLLLLLLLLaaLLLLLLLLLaaaLLRLLLLLLLLLLLLLLLLLLLLLLLLLLLLLLLLLLLLLLLLLLLLppppp
ppppLLLppppLLLppLLLLLLLLLLLLLLLLLLLaaLLLLLLLLLLLLRRLLLLLLLLLLLLLLLLLLLLLLLLLLLLLLLLLLLLLLLLLLLLppppp
pppLLLpppppLLLLppLLLLLLLLLLLLLLLLLLLaaaLLLLLLLLLLRLLLLLLLLLLLLLLLLLLLLLLLLLLLLLLLLLLLLLLLLLLLLpppppp
pppLLLppppppppLLppLLLLLLLLLLLLLLLLLLLLaaaLLLLLLLLRLLLLLLLLaaLLLLLLLLLLLLLLLLLLLLLLLLLLLLLLLLpppppppp
ppLLLppppppppppLLpppLLLLLLLLLLLLLLLLLLLLLLLLaaaLLLLLLLLLLaaLLLLLLLLLLLLLLLLLLLLLLLLLLLLLLLpppppppppp
ppLLppppppppppppLLpppLLLLLLLLLLLLLLLLLLLLLLLLLLLRLLLLLaLLLLLLLLLLLLpppppLLLLLLLLLLLLLLpppppppppppppp
pLLLppppppppppppppppppppLLLLLLLLLLLLLLLLLLLLLLLLRRLaaaaLLLLLLLLLLLpLLLpppppppppppLpppppppppppppppppp
pLLppppppppppppppppppppppppppLLLLLLLLLLLLLLLLLLLRRLLLLLLLLLLLLLLLppLLLLLLppppppppppppppppppppppppppp
pLLpppppppppppppppppppppLLLLLLLLLLLLLLLLLLLLLLLLRRLLLLLLLLLLLLLLLLLLLLLLLLLLLLLppppppppppppppppppppp
ppLLppppLLLLppppppppppppppLLLLLLLLLLLLLLLLLLLLLLRLRRLLLLLLLLLLLLLLLLLLLLLLLLLLLLLpppppppppLLLLLLLppp
ppLLpppLLppLLppppppppppppppppLLLLLLLLLLLLLLLLmmLRRRRLLLLLLLLLLLLLLLLLLLLLLLpppLLLLLLLppLLLLppppppppp
pppLLLLLppppppppppppppppppppppppLLLLLLLLLLLLpppddRRRLmmLLLLLLLLLLLLLLLLLLppppppppLLLLLLLLppppppppppp
pppppppppppppppppppppppppppppppppppppppppppppppdddRRmmmLLLLLLLLLLLLLLppppppppppppppppppppppppppppppp
pppppppppppppppppppppppppppppppppppppppppppppppdddddpppppppppppppppppppppppppppppppppppppppppppppppp
pppppppppppppppppppppppppppppppppppppppppppppppddddppppppppppppppppppppppppppppppppppppppppppppppppp
ppppppppppppppppppppppppppppppppppppppppppppppppdddppppppppppppppppppppppppppppppppppppppppppppppppp
pppppppppppppppppppppppppppppppppppppppppppppppppppppppppppppppppppppppppppppppppppppppppppppppppppp
"}
