//MAP CONVERTED BY dmm2tgm.py THIS HEADER COMMENT PREVENTS RECONVERSION, DO NOT REMOVE
"a" = (
/obj/machinery/alarm{
	dir = 1;
	pixel_y = -32
	},
/obj/structure/bookcase,
/turf/simulated/floor/tiled/dark/violetcorener,
/area/nadezhda/crew_quarters/techshop)
"f" = (
/obj/structure/disposalpipe/segment,
/obj/machinery/firealarm{
	dir = 4;
	pixel_x = -32
	},
/obj/effect/decal/cleanable/dirt,
/obj/effect/decal/cleanable/filth,
/turf/simulated/floor/tiled/dark/violetcorener,
/area/nadezhda/crew_quarters/techshop)
"g" = (
/obj/machinery/light,
/obj/structure/bookcase,
/turf/simulated/floor/tiled/dark/violetcorener,
/area/nadezhda/crew_quarters/techshop)
"j" = (
/obj/structure/bookcase,
/obj/item/oddity/common/old_newspaper,
/turf/simulated/floor/tiled/dark/violetcorener,
/area/nadezhda/crew_quarters/techshop)
"p" = (
/obj/machinery/camera/network/colony_underground{
	dir = 1
	},
/obj/structure/bookcase,
/turf/simulated/floor/tiled/dark/violetcorener,
/area/nadezhda/crew_quarters/techshop)
"r" = (
/obj/machinery/atmospherics/unary/vent_pump,
/obj/effect/decal/cleanable/dirt,
/turf/simulated/floor/tiled/dark/violetcorener,
/area/nadezhda/crew_quarters/techshop)
"t" = (
/obj/machinery/button/remote/airlock{
	id = "FS1";
	name = "Door Bolt Control";
	pixel_y = 24;
	specialfunctions = 4
	},
/obj/structure/table/standard,
/obj/item/newspaper,
/turf/simulated/floor/tiled/dark/violetcorener,
/area/nadezhda/crew_quarters/techshop)
"v" = (
/obj/machinery/atmospherics/pipe/simple/hidden/supply{
	dir = 5
	},
/obj/effect/decal/cleanable/dirt,
/turf/simulated/floor/tiled/dark/violetcorener,
/area/nadezhda/crew_quarters/techshop)
"w" = (
/obj/structure/bookcase,
/turf/simulated/floor/tiled/dark/violetcorener,
/area/nadezhda/crew_quarters/techshop)
"y" = (
/obj/item/device/lighting/toggleable/lamp,
/obj/structure/table/standard,
/obj/random/lowkeyrandom/low_chance,
/turf/simulated/floor/tiled/dark/violetcorener,
/area/nadezhda/crew_quarters/techshop)
"A" = (
/obj/structure/table/standard,
/obj/item/paper_bin,
/obj/random/lowkeyrandom/low_chance,
/turf/simulated/floor/tiled/dark/violetcorener,
/area/nadezhda/crew_quarters/techshop)
"B" = (
/obj/structure/disposalpipe/segment,
/obj/machinery/light{
	dir = 8
	},
/obj/machinery/light_switch{
	dir = 4;
	pixel_x = -32
	},
/obj/effect/decal/cleanable/dirt,
/obj/machinery/atmospherics/unary/vent_scrubber{
	dir = 1
	},
/turf/simulated/floor/tiled/dark/violetcorener,
/area/nadezhda/crew_quarters/techshop)
"G" = (
/obj/effect/decal/cleanable/dirt,
/obj/effect/decal/cleanable/filth,
/turf/simulated/floor/tiled/dark/violetcorener,
/area/nadezhda/crew_quarters/techshop)
"L" = (
/obj/machinery/disposal,
/obj/effect/floor_decal/industrial/box/red,
/obj/structure/disposalpipe/trunk{
	dir = 1
	},
/obj/item/device/radio/intercom{
	dir = 4;
	pixel_x = -22
	},
/turf/simulated/floor/tiled/dark/violetcorener,
/area/nadezhda/crew_quarters/techshop)
"R" = (
/obj/structure/bookcase,
/obj/item/oddity/common/paper_bundle,
/turf/simulated/floor/tiled/dark/violetcorener,
/area/nadezhda/crew_quarters/techshop)
"T" = (
/obj/machinery/atmospherics/pipe/simple/hidden/supply{
	dir = 4
	},
/obj/effect/decal/cleanable/dirt,
/obj/structure/bed/chair/office/dark{
	dir = 4
	},
/turf/simulated/floor/tiled/dark/violetcorener,
/area/nadezhda/crew_quarters/techshop)
"V" = (
/obj/structure/bed/chair,
/turf/simulated/floor/tiled/dark/violetcorener,
/area/nadezhda/crew_quarters/techshop)
"W" = (
/obj/effect/decal/cleanable/dirt,
/turf/simulated/floor/tiled/dark/violetcorener,
/area/nadezhda/crew_quarters/techshop)
"Z" = (
/obj/structure/disposalpipe/segment,
/obj/effect/decal/cleanable/dirt,
/turf/simulated/floor/tiled/dark/violetcorener,
/area/nadezhda/crew_quarters/techshop)

(1,1,1) = {"
B
Z
Z
Z
f
L
"}
(2,1,1) = {"
t
G
W
j
W
p
"}
(3,1,1) = {"
V
W
W
w
W
R
"}
(4,1,1) = {"
V
r
v
w
W
g
"}
(5,1,1) = {"
A
y
T
W
W
a
"}
