//MAP CONVERTED BY dmm2tgm.py THIS HEADER COMMENT PREVENTS RECONVERSION, DO NOT REMOVE
"a" = (
/obj/machinery/disposal,
/obj/effect/floor_decal/industrial/box/red,
/obj/structure/disposalpipe/trunk{
	dir = 1
	},
/obj/item/device/radio/intercom{
	dir = 4;
	pixel_x = -22
	},
/turf/simulated/floor/tiled/dark/violetcorener,
/area/nadezhda/crew_quarters/techshop)
"b" = (
/obj/machinery/atmospherics/pipe/simple/hidden/supply{
	dir = 4
	},
/obj/effect/decal/cleanable/dirt,
/turf/simulated/floor/tiled/dark/violetcorener,
/area/nadezhda/crew_quarters/techshop)
"d" = (
/obj/effect/decal/cleanable/dirt,
/obj/item/remains/mouse,
/turf/simulated/floor/tiled/dark/violetcorener,
/area/nadezhda/crew_quarters/techshop)
"g" = (
/obj/effect/decal/cleanable/dirt,
/obj/item/device/lighting/toggleable/lamp,
/turf/simulated/floor/tiled/dark/violetcorener,
/area/nadezhda/crew_quarters/techshop)
"k" = (
/obj/effect/decal/cleanable/dirt,
/obj/effect/decal/cleanable/filth,
/turf/simulated/floor/tiled/dark/violetcorener,
/area/nadezhda/crew_quarters/techshop)
"s" = (
/obj/structure/disposalpipe/segment,
/obj/machinery/light{
	dir = 8
	},
/obj/machinery/light_switch{
	dir = 4;
	pixel_x = -32
	},
/obj/effect/decal/cleanable/dirt,
/obj/machinery/atmospherics/unary/vent_scrubber{
	dir = 1
	},
/turf/simulated/floor/tiled/dark/violetcorener,
/area/nadezhda/crew_quarters/techshop)
"t" = (
/obj/structure/table/rack/shelf,
/obj/machinery/alarm{
	dir = 1;
	pixel_y = -32
	},
/obj/random/rations/low_chance,
/turf/simulated/floor/tiled/dark/violetcorener,
/area/nadezhda/crew_quarters/techshop)
"v" = (
/obj/structure/disposalpipe/segment,
/obj/machinery/firealarm{
	dir = 4;
	pixel_x = -32
	},
/obj/effect/decal/cleanable/dirt,
/obj/effect/decal/cleanable/filth,
/turf/simulated/floor/tiled/dark/violetcorener,
/area/nadezhda/crew_quarters/techshop)
"x" = (
/obj/machinery/atmospherics/unary/vent_pump,
/obj/effect/decal/cleanable/dirt,
/turf/simulated/floor/tiled/dark/violetcorener,
/area/nadezhda/crew_quarters/techshop)
"y" = (
/obj/effect/decal/cleanable/dirt,
/obj/item/trash/liquidfood,
/turf/simulated/floor/tiled/dark/violetcorener,
/area/nadezhda/crew_quarters/techshop)
"z" = (
/obj/structure/table/steel_reinforced,
/turf/simulated/floor/tiled/dark/violetcorener,
/area/nadezhda/crew_quarters/techshop)
"A" = (
/obj/effect/decal/cleanable/dirt,
/obj/effect/decal/cleanable/filth,
/obj/item/trash/candy/proteinbar,
/turf/simulated/floor/tiled/dark/violetcorener,
/area/nadezhda/crew_quarters/techshop)
"B" = (
/obj/structure/disposalpipe/segment,
/obj/effect/decal/cleanable/dirt,
/obj/random/scrap,
/turf/simulated/floor/tiled/dark/violetcorener,
/area/nadezhda/crew_quarters/techshop)
"D" = (
/obj/effect/decal/cleanable/dirt,
/turf/simulated/floor/tiled/dark/violetcorener,
/area/nadezhda/crew_quarters/techshop)
"I" = (
/obj/structure/disposalpipe/segment,
/obj/effect/decal/cleanable/dirt,
/turf/simulated/floor/tiled/dark/violetcorener,
/area/nadezhda/crew_quarters/techshop)
"J" = (
/obj/machinery/atmospherics/pipe/simple/hidden/supply{
	dir = 5
	},
/obj/effect/decal/cleanable/dirt,
/turf/simulated/floor/tiled/dark/violetcorener,
/area/nadezhda/crew_quarters/techshop)
"K" = (
/obj/structure/table/rack,
/obj/random/contraband/low_chance,
/obj/machinery/button/remote/airlock{
	id = "FS1";
	name = "Door Bolt Control";
	pixel_y = 24;
	specialfunctions = 4
	},
/turf/simulated/floor/tiled/dark/violetcorener,
/area/nadezhda/crew_quarters/techshop)
"M" = (
/obj/structure/table/rack/shelf,
/obj/machinery/light,
/turf/simulated/floor/tiled/dark/violetcorener,
/area/nadezhda/crew_quarters/techshop)
"N" = (
/obj/effect/decal/cleanable/dirt,
/obj/structure/bed/chair/office/dark,
/turf/simulated/floor/tiled/dark/violetcorener,
/area/nadezhda/crew_quarters/techshop)
"O" = (
/obj/structure/table/rack,
/turf/simulated/floor/tiled/dark/violetcorener,
/area/nadezhda/crew_quarters/techshop)
"P" = (
/obj/structure/table/rack/shelf,
/turf/simulated/floor/tiled/dark/violetcorener,
/area/nadezhda/crew_quarters/techshop)
"R" = (
/obj/machinery/camera/network/colony_underground{
	dir = 1
	},
/turf/simulated/floor/tiled/dark/violetcorener,
/area/nadezhda/crew_quarters/techshop)
"V" = (
/obj/effect/decal/cleanable/dirt,
/obj/item/trash/chips,
/turf/simulated/floor/tiled/dark/violetcorener,
/area/nadezhda/crew_quarters/techshop)
"X" = (
/obj/effect/decal/cleanable/dirt,
/obj/random/lowkeyrandom/low_chance,
/turf/simulated/floor/tiled/dark/violetcorener,
/area/nadezhda/crew_quarters/techshop)

(1,1,1) = {"
s
I
I
B
v
a
"}
(2,1,1) = {"
K
A
g
y
D
R
"}
(3,1,1) = {"
O
D
D
N
X
P
"}
(4,1,1) = {"
O
x
J
d
D
M
"}
(5,1,1) = {"
z
X
b
k
V
t
"}
