//MAP CONVERTED BY dmm2tgm.py THIS HEADER COMMENT PREVENTS RECONVERSION, DO NOT REMOVE
"a" = (
/obj/structure/disposalpipe/segment,
/obj/effect/decal/cleanable/dirt,
/turf/simulated/floor/tiled/dark/violetcorener,
/area/nadezhda/crew_quarters/techshop)
"e" = (
/obj/item/device/lighting/toggleable/lamp,
/obj/structure/table/standard,
/obj/item/tool/screwdriver/improvised,
/turf/simulated/floor/tiled/dark/violetcorener,
/area/nadezhda/crew_quarters/techshop)
"k" = (
/obj/structure/table/rack/shelf,
/obj/item/frame/apc,
/obj/item/frame/apc,
/turf/simulated/floor/tiled/dark/violetcorener,
/area/nadezhda/crew_quarters/techshop)
"l" = (
/obj/structure/table/standard,
/obj/item/stock_parts/micro_laser,
/obj/item/tool/wrench/improvised,
/turf/simulated/floor/tiled/dark/violetcorener,
/area/nadezhda/crew_quarters/techshop)
"m" = (
/obj/machinery/constructable_frame/machine_frame,
/obj/item/stack/cable_coil/random,
/turf/simulated/floor/tiled/dark/violetcorener,
/area/nadezhda/crew_quarters/techshop)
"o" = (
/obj/structure/disposalpipe/segment,
/obj/machinery/firealarm{
	dir = 4;
	pixel_x = -32
	},
/obj/effect/decal/cleanable/dirt,
/obj/effect/decal/cleanable/filth,
/turf/simulated/floor/tiled/dark/violetcorener,
/area/nadezhda/crew_quarters/techshop)
"q" = (
/obj/structure/disposalpipe/segment,
/obj/machinery/light{
	dir = 8
	},
/obj/machinery/light_switch{
	dir = 4;
	pixel_x = -32
	},
/obj/effect/decal/cleanable/dirt,
/obj/machinery/atmospherics/unary/vent_scrubber{
	dir = 1
	},
/turf/simulated/floor/tiled/dark/violetcorener,
/area/nadezhda/crew_quarters/techshop)
"v" = (
/obj/machinery/alarm{
	dir = 1;
	pixel_y = -32
	},
/obj/machinery/constructable_frame/machine_frame,
/obj/item/stack/cable_coil/random,
/turf/simulated/floor/tiled/dark/violetcorener,
/area/nadezhda/crew_quarters/techshop)
"B" = (
/obj/machinery/atmospherics/pipe/simple/hidden/supply{
	dir = 4
	},
/obj/effect/decal/cleanable/dirt,
/obj/structure/bed/chair/office/dark{
	dir = 4
	},
/turf/simulated/floor/tiled/dark/violetcorener,
/area/nadezhda/crew_quarters/techshop)
"C" = (
/obj/structure/table/standard,
/obj/item/stock_parts/capacitor,
/obj/item/stock_parts/capacitor,
/turf/simulated/floor/tiled/dark/violetcorener,
/area/nadezhda/crew_quarters/techshop)
"F" = (
/obj/machinery/button/remote/airlock{
	id = "FS1";
	name = "Door Bolt Control";
	pixel_y = 24;
	specialfunctions = 4
	},
/obj/structure/computerframe,
/obj/item/stock_parts/console_screen,
/obj/item/stock_parts/console_screen,
/turf/simulated/floor/tiled/dark/violetcorener,
/area/nadezhda/crew_quarters/techshop)
"G" = (
/obj/machinery/disposal,
/obj/effect/floor_decal/industrial/box/red,
/obj/structure/disposalpipe/trunk{
	dir = 1
	},
/obj/item/device/radio/intercom{
	dir = 4;
	pixel_x = -22
	},
/turf/simulated/floor/tiled/dark/violetcorener,
/area/nadezhda/crew_quarters/techshop)
"I" = (
/obj/machinery/light,
/obj/structure/table/standard,
/obj/item/stock_parts/matter_bin,
/turf/simulated/floor/tiled/dark/violetcorener,
/area/nadezhda/crew_quarters/techshop)
"J" = (
/obj/machinery/atmospherics/unary/vent_pump,
/obj/effect/decal/cleanable/dirt,
/turf/simulated/floor/tiled/dark/violetcorener,
/area/nadezhda/crew_quarters/techshop)
"N" = (
/obj/structure/table/rack/shelf,
/obj/item/frame/light,
/obj/item/frame/light,
/obj/item/frame/light,
/obj/item/frame/light/small,
/obj/item/frame/light/small,
/turf/simulated/floor/tiled/dark/violetcorener,
/area/nadezhda/crew_quarters/techshop)
"O" = (
/obj/effect/decal/cleanable/dirt,
/obj/effect/decal/cleanable/filth,
/turf/simulated/floor/tiled/dark/violetcorener,
/area/nadezhda/crew_quarters/techshop)
"Q" = (
/obj/machinery/camera/network/colony_underground{
	dir = 1
	},
/obj/machinery/constructable_frame/machine_frame,
/obj/item/stock_parts/manipulator,
/turf/simulated/floor/tiled/dark/violetcorener,
/area/nadezhda/crew_quarters/techshop)
"T" = (
/obj/effect/decal/cleanable/dirt,
/turf/simulated/floor/tiled/dark/violetcorener,
/area/nadezhda/crew_quarters/techshop)
"V" = (
/obj/machinery/atmospherics/pipe/simple/hidden/supply{
	dir = 5
	},
/obj/effect/decal/cleanable/dirt,
/turf/simulated/floor/tiled/dark/violetcorener,
/area/nadezhda/crew_quarters/techshop)
"X" = (
/obj/machinery/constructable_frame/machine_frame,
/obj/item/stock_parts/scanning_module,
/turf/simulated/floor/tiled/dark/violetcorener,
/area/nadezhda/crew_quarters/techshop)
"Y" = (
/obj/structure/computerframe,
/obj/item/stock_parts/console_screen,
/turf/simulated/floor/tiled/dark/violetcorener,
/area/nadezhda/crew_quarters/techshop)

(1,1,1) = {"
q
a
a
a
o
G
"}
(2,1,1) = {"
F
O
T
k
T
Q
"}
(3,1,1) = {"
Y
T
T
m
T
l
"}
(4,1,1) = {"
X
J
V
N
T
I
"}
(5,1,1) = {"
C
e
B
T
T
v
"}
