//MAP CONVERTED BY dmm2tgm.py THIS HEADER COMMENT PREVENTS RECONVERSION, DO NOT REMOVE
"a" = (
/obj/structure/disposalpipe/segment,
/obj/effect/decal/cleanable/dirt,
/turf/simulated/floor/tiled/dark/violetcorener,
/area/nadezhda/crew_quarters/techshop)
"b" = (
/obj/structure/table/standard,
/obj/random/lowkeyrandom/low_chance,
/turf/simulated/floor/tiled/dark/violetcorener,
/area/nadezhda/crew_quarters/techshop)
"d" = (
/obj/structure/table,
/turf/simulated/floor/tiled/dark/violetcorener,
/area/nadezhda/crew_quarters/techshop)
"e" = (
/obj/effect/decal/cleanable/dirt,
/turf/simulated/floor/tiled/dark/violetcorener,
/area/nadezhda/crew_quarters/techshop)
"m" = (
/obj/machinery/light,
/obj/structure/table/standard,
/obj/random/lowkeyrandom/low_chance,
/turf/simulated/floor/tiled/dark/violetcorener,
/area/nadezhda/crew_quarters/techshop)
"n" = (
/obj/machinery/button/remote/airlock{
	id = "FS1";
	name = "Door Bolt Control";
	pixel_y = 24;
	specialfunctions = 4
	},
/obj/structure/table/standard,
/turf/simulated/floor/tiled/dark/violetcorener,
/area/nadezhda/crew_quarters/techshop)
"t" = (
/obj/machinery/camera/network/colony_underground{
	dir = 1
	},
/obj/structure/table/standard,
/turf/simulated/floor/tiled/dark/violetcorener,
/area/nadezhda/crew_quarters/techshop)
"v" = (
/obj/structure/table/standard,
/turf/simulated/floor/tiled/dark/violetcorener,
/area/nadezhda/crew_quarters/techshop)
"B" = (
/obj/machinery/disposal,
/obj/effect/floor_decal/industrial/box/red,
/obj/structure/disposalpipe/trunk{
	dir = 1
	},
/obj/item/device/radio/intercom{
	dir = 4;
	pixel_x = -22
	},
/turf/simulated/floor/tiled/dark/violetcorener,
/area/nadezhda/crew_quarters/techshop)
"E" = (
/obj/machinery/atmospherics/pipe/simple/hidden/supply{
	dir = 5
	},
/obj/effect/decal/cleanable/dirt,
/turf/simulated/floor/tiled/dark/violetcorener,
/area/nadezhda/crew_quarters/techshop)
"G" = (
/obj/structure/table/standard,
/obj/item/device/lighting/toggleable/lamp,
/turf/simulated/floor/tiled/dark/violetcorener,
/area/nadezhda/crew_quarters/techshop)
"I" = (
/obj/machinery/alarm{
	dir = 1;
	pixel_y = -32
	},
/obj/structure/table/standard,
/turf/simulated/floor/tiled/dark/violetcorener,
/area/nadezhda/crew_quarters/techshop)
"M" = (
/obj/machinery/atmospherics/pipe/simple/hidden/supply{
	dir = 4
	},
/obj/effect/decal/cleanable/dirt,
/obj/structure/bed/chair/office/dark{
	dir = 4
	},
/turf/simulated/floor/tiled/dark/violetcorener,
/area/nadezhda/crew_quarters/techshop)
"N" = (
/obj/structure/disposalpipe/segment,
/obj/machinery/light{
	dir = 8
	},
/obj/machinery/light_switch{
	dir = 4;
	pixel_x = -32
	},
/obj/effect/decal/cleanable/dirt,
/obj/machinery/atmospherics/unary/vent_scrubber{
	dir = 1
	},
/turf/simulated/floor/tiled/dark/violetcorener,
/area/nadezhda/crew_quarters/techshop)
"O" = (
/obj/effect/decal/cleanable/dirt,
/obj/effect/decal/cleanable/filth,
/turf/simulated/floor/tiled/dark/violetcorener,
/area/nadezhda/crew_quarters/techshop)
"P" = (
/obj/machinery/atmospherics/unary/vent_pump,
/obj/effect/decal/cleanable/dirt,
/turf/simulated/floor/tiled/dark/violetcorener,
/area/nadezhda/crew_quarters/techshop)
"Q" = (
/obj/structure/disposalpipe/segment,
/obj/machinery/firealarm{
	dir = 4;
	pixel_x = -32
	},
/obj/effect/decal/cleanable/dirt,
/obj/effect/decal/cleanable/filth,
/turf/simulated/floor/tiled/dark/violetcorener,
/area/nadezhda/crew_quarters/techshop)

(1,1,1) = {"
N
a
a
a
Q
B
"}
(2,1,1) = {"
n
O
e
d
e
t
"}
(3,1,1) = {"
d
e
e
b
e
d
"}
(4,1,1) = {"
d
P
E
d
e
m
"}
(5,1,1) = {"
v
G
M
e
e
I
"}
