//MAP CONVERTED BY dmm2tgm.py THIS HEADER COMMENT PREVENTS RECONVERSION, DO NOT REMOVE
"a" = (
/obj/structure/disposalpipe/segment,
/obj/machinery/firealarm{
	dir = 4;
	pixel_x = -32
	},
/obj/effect/decal/cleanable/dirt,
/obj/effect/decal/cleanable/filth,
/obj/random/junk,
/turf/simulated/floor/tiled/dark/violetcorener,
/area/nadezhda/crew_quarters/techshop)
"b" = (
/obj/random/junk,
/turf/simulated/floor/tiled/dark/violetcorener,
/area/nadezhda/crew_quarters/techshop)
"d" = (
/obj/effect/decal/cleanable/dirt,
/obj/effect/decal/cleanable/filth,
/obj/effect/decal/cleanable/filth,
/obj/item/device/assembly/mousetrap/armed,
/turf/simulated/floor/tiled/dark/violetcorener,
/area/nadezhda/crew_quarters/techshop)
"e" = (
/obj/effect/decal/cleanable/dirt,
/obj/effect/decal/cleanable/filth,
/obj/item/reagent_containers/food/drinks/cans/waterbottle,
/obj/structure/cyberplant,
/turf/simulated/floor/tiled/dark/violetcorener,
/area/nadezhda/crew_quarters/techshop)
"g" = (
/obj/effect/decal/cleanable/dirt,
/obj/effect/decal/cleanable/filth,
/obj/item/device/assembly/mousetrap/armed,
/turf/simulated/floor/tiled/dark/violetcorener,
/area/nadezhda/crew_quarters/techshop)
"h" = (
/obj/effect/decal/cleanable/dirt,
/obj/random/junk,
/turf/simulated/floor/tiled/dark/violetcorener,
/area/nadezhda/crew_quarters/techshop)
"l" = (
/obj/machinery/atmospherics/pipe/simple/hidden/supply{
	dir = 5
	},
/obj/effect/decal/cleanable/dirt,
/turf/simulated/floor/tiled/dark/violetcorener,
/area/nadezhda/crew_quarters/techshop)
"n" = (
/obj/machinery/camera/network/colony_underground{
	dir = 1
	},
/obj/random/scrap/dense_even,
/turf/simulated/floor/tiled/dark/violetcorener,
/area/nadezhda/crew_quarters/techshop)
"o" = (
/obj/machinery/atmospherics/unary/vent_pump,
/obj/effect/decal/cleanable/dirt,
/obj/random/junk,
/turf/simulated/floor/tiled/dark/violetcorener,
/area/nadezhda/crew_quarters/techshop)
"r" = (
/obj/structure/disposalpipe/segment,
/obj/effect/decal/cleanable/dirt,
/obj/random/junkfood/rotten/low_chance,
/turf/simulated/floor/tiled/dark/violetcorener,
/area/nadezhda/crew_quarters/techshop)
"u" = (
/obj/machinery/button/remote/airlock{
	id = "FS1";
	name = "Door Bolt Control";
	pixel_y = 24;
	specialfunctions = 4
	},
/obj/effect/decal/cleanable/filth,
/obj/random/junkfood/rotten/low_chance,
/turf/simulated/floor/tiled/dark/violetcorener,
/area/nadezhda/crew_quarters/techshop)
"v" = (
/obj/structure/table/rack/shelf,
/obj/random/lowkeyrandom,
/turf/simulated/floor/tiled/dark/violetcorener,
/area/nadezhda/crew_quarters/techshop)
"y" = (
/obj/machinery/light,
/obj/machinery/microwave/burnbarrel,
/obj/item/stack/material/wood/random,
/obj/random/junkfood/rotten/low_chance,
/turf/simulated/floor/tiled/dark/violetcorener,
/area/nadezhda/crew_quarters/techshop)
"C" = (
/obj/item/device/lighting/toggleable/lamp,
/obj/structure/table/reinforced,
/turf/simulated/floor/tiled/dark/violetcorener,
/area/nadezhda/crew_quarters/techshop)
"D" = (
/obj/effect/decal/cleanable/dirt,
/obj/random/lowkeyrandom/low_chance,
/turf/simulated/floor/tiled/dark/violetcorener,
/area/nadezhda/crew_quarters/techshop)
"E" = (
/obj/machinery/atmospherics/pipe/simple/hidden/supply{
	dir = 4
	},
/obj/effect/decal/cleanable/dirt,
/obj/structure/bed/chair/office/dark{
	dir = 4
	},
/turf/simulated/floor/tiled/dark/violetcorener,
/area/nadezhda/crew_quarters/techshop)
"F" = (
/obj/effect/decal/cleanable/dirt,
/turf/simulated/floor/tiled/dark/violetcorener,
/area/nadezhda/crew_quarters/techshop)
"H" = (
/obj/effect/decal/cleanable/dirt,
/obj/effect/decal/cleanable/filth,
/obj/structure/scrap/poor,
/turf/simulated/floor/tiled/dark/violetcorener,
/area/nadezhda/crew_quarters/techshop)
"I" = (
/obj/machinery/alarm{
	dir = 1;
	pixel_y = -32
	},
/obj/random/junk,
/obj/random/furniture/bedsheet,
/obj/random/lowkeyrandom/low_chance,
/turf/simulated/floor/tiled/dark/violetcorener,
/area/nadezhda/crew_quarters/techshop)
"J" = (
/obj/random/scrap/dense_even,
/turf/simulated/floor/tiled/dark/violetcorener,
/area/nadezhda/crew_quarters/techshop)
"L" = (
/obj/structure/disposalpipe/segment,
/obj/effect/decal/cleanable/dirt,
/turf/simulated/floor/tiled/dark/violetcorener,
/area/nadezhda/crew_quarters/techshop)
"M" = (
/obj/effect/decal/cleanable/dirt,
/obj/structure/closet/crate/trashcart,
/turf/simulated/floor/tiled/dark/violetcorener,
/area/nadezhda/crew_quarters/techshop)
"N" = (
/obj/structure/disposalpipe/segment,
/obj/machinery/light{
	dir = 8
	},
/obj/machinery/light_switch{
	dir = 4;
	pixel_x = -32
	},
/obj/effect/decal/cleanable/dirt,
/obj/random/traps/low_chance,
/obj/machinery/atmospherics/unary/vent_scrubber{
	dir = 1
	},
/turf/simulated/floor/tiled/dark/violetcorener,
/area/nadezhda/crew_quarters/techshop)
"U" = (
/obj/effect/decal/cleanable/filth,
/obj/structure/scrap/poor,
/turf/simulated/floor/tiled/dark/violetcorener,
/area/nadezhda/crew_quarters/techshop)
"Y" = (
/obj/machinery/disposal,
/obj/effect/floor_decal/industrial/box/red,
/obj/structure/disposalpipe/trunk{
	dir = 1
	},
/obj/item/device/radio/intercom{
	dir = 4;
	pixel_x = -22
	},
/turf/simulated/floor/tiled/dark/violetcorener,
/area/nadezhda/crew_quarters/techshop)
"Z" = (
/obj/structure/disposalpipe/segment,
/obj/effect/decal/cleanable/dirt,
/obj/random/junk,
/turf/simulated/floor/tiled/dark/violetcorener,
/area/nadezhda/crew_quarters/techshop)

(1,1,1) = {"
N
Z
L
r
a
Y
"}
(2,1,1) = {"
u
d
M
U
D
n
"}
(3,1,1) = {"
J
D
F
b
H
J
"}
(4,1,1) = {"
J
o
l
v
g
y
"}
(5,1,1) = {"
b
C
E
h
e
I
"}
