//MAP CONVERTED BY dmm2tgm.py THIS HEADER COMMENT PREVENTS RECONVERSION, DO NOT REMOVE
"a" = (
/obj/effect/decal/cleanable/dirt,
/obj/random/closet_maintloot/low_chance,
/turf/simulated/floor/plating/under,
/area/nadezhda/maintenance/undergroundfloor2west)
"f" = (
/obj/effect/decal/cleanable/dirt,
/obj/machinery/light/small{
	dir = 8
	},
/obj/random/mob/roaches,
/turf/simulated/floor/plating/under,
/area/nadezhda/maintenance/undergroundfloor2west)
"h" = (
/obj/effect/decal/cleanable/dirt,
/obj/random/scrap/dense_even,
/turf/simulated/floor/plating/under,
/area/nadezhda/maintenance/undergroundfloor2west)
"o" = (
/obj/effect/decal/cleanable/dirt,
/obj/machinery/light/small{
	dir = 8
	},
/obj/random/junk,
/turf/simulated/floor/plating/under,
/area/nadezhda/maintenance/undergroundfloor2west)
"q" = (
/obj/effect/decal/cleanable/dirt,
/obj/random/junkfood/rotten/low_chance,
/turf/simulated/floor/plating/under,
/area/nadezhda/maintenance/undergroundfloor2west)
"u" = (
/obj/effect/decal/cleanable/dirt,
/obj/random/junkfood/rotten/low_chance,
/obj/random/pack/junk_machine/low_chance,
/turf/simulated/floor/plating/under,
/area/nadezhda/maintenance/undergroundfloor2west)
"y" = (
/obj/effect/decal/cleanable/dirt,
/obj/random/scrap/sparse_even/low_chance,
/obj/random/mob/roaches,
/turf/simulated/floor/plating/under,
/area/nadezhda/maintenance/undergroundfloor2west)
"A" = (
/obj/effect/decal/cleanable/dirt,
/obj/random/scrap/sparse_even/low_chance,
/turf/simulated/floor/plating/under,
/area/nadezhda/maintenance/undergroundfloor2west)
"T" = (
/obj/effect/decal/cleanable/dirt,
/obj/random/junk,
/obj/random/pack/junk_machine/low_chance,
/turf/simulated/floor/plating/under,
/area/nadezhda/maintenance/undergroundfloor2west)

(1,1,1) = {"
f
q
o
a
"}
(2,1,1) = {"
A
y
q
a
"}
(3,1,1) = {"
h
A
A
u
"}
(4,1,1) = {"
h
h
A
T
"}
