//MAP CONVERTED BY dmm2tgm.py THIS HEADER COMMENT PREVENTS RECONVERSION, DO NOT REMOVE
"a" = (
/turf/simulated/mineral/random/rogue,
/area/space)
"b" = (
/obj/structure/flora/big/bush3,
/turf/simulated/floor/asteroid/grass,
/area/space)
"d" = (
/obj/structure/flora/small/busha2,
/obj/landmark/storyevent/midgame_stash_spawn,
/turf/simulated/floor/asteroid/grass,
/area/space)
"f" = (
/obj/structure/flora/ausbushes/fullgrass,
/turf/simulated/floor/asteroid/grass,
/area/space)
"g" = (
/obj/structure/flora/small/bushc1,
/obj/structure/flora/small/busha2,
/turf/unsimulated/wall/jungle,
/area/space)
"h" = (
/obj/structure/flora/ausbushes/grassybush,
/turf/unsimulated/wall/jungle,
/area/space)
"j" = (
/obj/random/flora/small_jungle_tree,
/turf/unsimulated/wall/jungle,
/area/space)
"k" = (
/obj/structure/flora/small/busha2,
/obj/structure/flora/small/busha2,
/turf/simulated/mineral/planet,
/area/space)
"m" = (
/obj/random/flora/jungle_tree,
/turf/unsimulated/wall/jungle,
/area/space)
"n" = (
/obj/structure/flora/small/busha2,
/turf/simulated/floor/asteroid/grass,
/area/space)
"q" = (
/obj/structure/flora/big/bush2,
/turf/simulated/mineral/planet,
/area/space)
"r" = (
/obj/structure/flora/small/bushb1,
/turf/simulated/floor/asteroid/grass,
/area/space)
"s" = (
/turf/space,
/area/space)
"t" = (
/obj/structure/flora/ausbushes/fullgrass,
/turf/unsimulated/wall/jungle,
/area/space)
"w" = (
/obj/structure/flora/small/busha2,
/obj/random/mob/voidwolf/low_chance,
/turf/simulated/floor/asteroid/grass,
/area/space)
"x" = (
/obj/structure/flora/small/bushc1,
/turf/simulated/floor/asteroid/grass,
/area/space)
"y" = (
/turf/simulated/mineral/planet,
/area/space)
"z" = (
/obj/structure/flora/big/bush3,
/obj/random/traps/low_chance,
/turf/simulated/floor/asteroid/grass,
/area/space)
"A" = (
/obj/structure/flora/big/bush2,
/turf/simulated/floor/asteroid/grass,
/area/space)
"D" = (
/obj/random/flora/jungle_tree,
/turf/simulated/floor/asteroid/grass,
/area/space)
"E" = (
/obj/structure/flora/small/bushb1,
/turf/unsimulated/wall/jungle,
/area/space)
"F" = (
/obj/structure/flora/small/busha2,
/obj/random/traps,
/turf/simulated/floor/asteroid/grass,
/area/space)
"G" = (
/obj/structure/flora/big/bush2,
/turf/unsimulated/wall/jungle,
/area/space)
"H" = (
/obj/structure/flora/ausbushes/grassybush,
/turf/simulated/floor/asteroid/grass,
/area/space)
"J" = (
/obj/structure/flora/ausbushes/fullgrass,
/obj/structure/flora/big/bush3,
/turf/simulated/mineral/planet,
/area/space)
"K" = (
/turf/simulated/floor/asteroid/grass,
/area/space)
"L" = (
/obj/random/traps/low_chance,
/turf/simulated/floor/asteroid/grass,
/area/space)
"M" = (
/turf/simulated/floor/rock/manmade/concrete,
/area/space)
"N" = (
/obj/structure/flora/small/bushc1,
/turf/simulated/mineral/planet,
/area/space)
"R" = (
/obj/random/flora/jungle_tree,
/turf/simulated/mineral/planet,
/area/space)
"S" = (
/obj/structure/flora/small/bushb1,
/turf/simulated/mineral/planet,
/area/space)
"U" = (
/obj/structure/flora/big/bush3,
/turf/unsimulated/wall/jungle,
/area/space)
"V" = (
/turf/unsimulated/wall/jungle,
/area/space)
"W" = (
/obj/structure/flora/big/bush3,
/turf/simulated/mineral/planet,
/area/space)
"X" = (
/obj/structure/flora/small/busha2,
/turf/simulated/mineral/planet,
/area/space)
"Y" = (
/obj/structure/flora/small/busha2,
/turf/unsimulated/wall/jungle,
/area/space)
"Z" = (
/obj/structure/flora/small/bushc1,
/turf/unsimulated/wall/jungle,
/area/space)

(1,1,1) = {"
a
a
a
a
a
a
a
a
a
a
a
a
a
a
a
a
a
a
a
a
a
a
a
a
a
a
a
a
a
a
"}
(2,1,1) = {"
a
a
a
a
a
a
a
a
a
a
a
a
a
a
a
a
a
a
a
a
a
a
a
a
a
a
a
a
a
a
"}
(3,1,1) = {"
a
a
a
a
a
a
a
a
a
a
a
a
a
a
a
a
a
a
a
a
a
a
a
a
a
a
a
a
a
a
"}
(4,1,1) = {"
a
a
a
a
a
a
a
a
a
a
a
a
a
a
a
a
a
a
a
a
a
a
a
a
a
a
a
a
a
a
"}
(5,1,1) = {"
a
a
a
a
a
a
a
a
a
a
a
a
a
a
a
a
a
a
a
a
a
a
a
a
a
a
a
a
a
a
"}
(6,1,1) = {"
a
a
a
a
a
a
a
a
a
a
a
a
a
a
a
a
a
a
a
a
a
a
a
a
a
a
a
a
a
a
"}
(7,1,1) = {"
a
a
a
a
a
a
a
a
a
a
a
a
a
a
a
a
a
a
a
a
a
a
a
a
a
a
a
a
a
a
"}
(8,1,1) = {"
a
a
a
a
a
a
a
a
a
a
a
a
a
a
a
a
a
a
a
a
a
a
a
a
a
a
a
a
a
a
"}
(9,1,1) = {"
a
a
a
a
a
a
a
a
a
a
a
a
a
a
a
a
a
a
a
a
a
a
a
a
a
a
a
a
a
a
"}
(10,1,1) = {"
a
a
a
a
a
a
a
a
a
a
a
a
a
a
a
a
a
a
a
a
a
a
a
a
a
a
a
a
a
a
"}
(11,1,1) = {"
a
a
a
a
a
a
a
a
s
s
s
s
s
s
s
s
s
s
s
a
a
a
a
a
a
a
a
a
a
a
"}
(12,1,1) = {"
a
a
a
a
a
a
a
a
s
s
s
s
s
s
s
s
s
s
s
a
a
a
a
a
a
a
a
a
a
a
"}
(13,1,1) = {"
a
a
a
a
a
a
a
a
s
s
s
s
s
s
s
s
s
s
s
a
a
a
a
a
a
a
a
a
a
a
"}
(14,1,1) = {"
a
a
a
a
a
a
a
a
s
s
s
s
s
s
s
s
s
s
s
a
a
a
a
a
a
a
a
a
a
a
"}
(15,1,1) = {"
a
a
a
a
a
a
a
a
s
s
s
s
s
s
s
s
s
s
s
a
a
a
a
a
a
a
a
a
a
a
"}
(16,1,1) = {"
a
a
a
a
a
a
a
a
s
s
s
s
s
s
s
s
s
s
s
a
a
a
a
a
a
a
a
a
a
a
"}
(17,1,1) = {"
a
a
a
a
a
a
a
a
s
s
s
s
s
s
s
s
s
s
s
a
a
a
a
a
a
a
a
a
a
a
"}
(18,1,1) = {"
a
a
a
a
a
a
a
a
s
s
s
s
s
s
s
s
s
s
s
a
a
a
a
a
a
a
a
a
a
a
"}
(19,1,1) = {"
a
a
a
a
a
a
a
a
s
s
s
s
s
s
s
s
s
s
s
a
a
a
a
a
a
a
a
a
a
a
"}
(20,1,1) = {"
a
a
a
a
a
a
a
a
s
s
s
s
s
s
s
s
s
s
s
a
a
a
a
a
a
a
a
a
a
a
"}
(21,1,1) = {"
a
a
a
a
a
a
a
a
s
s
s
s
s
s
s
s
s
s
s
a
a
a
a
a
a
a
a
a
a
a
"}
(22,1,1) = {"
a
a
a
a
a
a
a
a
s
s
s
s
s
s
s
s
s
s
s
a
a
a
a
a
a
a
a
a
a
a
"}
(23,1,1) = {"
a
a
a
a
a
a
a
a
s
s
s
s
s
s
s
s
s
s
s
a
a
a
a
a
a
a
a
a
a
a
"}
(24,1,1) = {"
a
a
a
a
a
a
a
a
s
s
s
s
s
s
s
s
s
s
s
a
a
a
a
a
a
a
a
a
a
a
"}
(25,1,1) = {"
a
a
a
a
a
a
a
a
a
a
a
a
a
a
a
a
a
a
a
a
a
a
a
a
a
a
a
a
a
a
"}
(26,1,1) = {"
a
a
a
a
a
a
a
a
a
a
a
a
a
a
a
a
a
a
a
a
a
a
a
a
a
a
a
a
a
a
"}
(27,1,1) = {"
a
a
a
a
a
a
a
a
a
a
a
a
a
a
a
a
a
a
a
a
a
a
a
a
a
a
a
a
a
a
"}
(28,1,1) = {"
a
a
a
a
a
a
a
a
a
a
a
a
a
a
a
a
a
a
a
a
a
a
a
a
a
a
a
a
a
a
"}
(29,1,1) = {"
a
a
a
a
a
a
a
a
a
a
a
a
a
a
a
a
a
a
a
a
a
a
a
a
a
a
a
a
a
a
"}
(30,1,1) = {"
a
a
a
a
a
a
a
a
a
a
a
a
a
a
a
a
a
a
a
a
a
a
a
a
a
a
a
a
a
a
"}

(1,1,2) = {"
V
Z
x
K
K
K
x
K
K
K
K
x
K
H
V
V
V
V
V
V
V
V
V
V
V
V
V
V
V
V
"}
(2,1,2) = {"
V
Z
K
K
K
K
K
K
K
K
K
K
K
K
K
Z
S
X
y
V
V
V
V
V
V
V
V
V
V
V
"}
(3,1,2) = {"
y
x
H
K
K
K
K
V
V
V
V
m
K
K
n
K
K
r
x
Y
V
V
V
V
V
V
V
V
V
V
"}
(4,1,2) = {"
y
K
K
K
K
Z
Z
V
V
V
V
V
V
X
n
K
K
K
x
N
V
V
V
V
V
V
V
V
V
V
"}
(5,1,2) = {"
V
K
D
K
g
V
V
V
V
V
V
V
X
K
K
K
K
K
F
S
Z
V
V
V
V
V
V
V
V
V
"}
(6,1,2) = {"
K
K
K
K
k
V
V
V
V
V
Y
X
K
K
K
K
R
E
r
r
V
V
V
V
V
V
V
V
V
V
"}
(7,1,2) = {"
n
K
K
K
X
V
V
V
m
K
K
K
K
K
y
V
V
V
h
K
V
V
V
V
V
V
V
V
V
V
"}
(8,1,2) = {"
n
K
K
F
Y
V
V
V
K
K
H
K
K
y
V
V
V
V
V
K
K
V
V
V
V
V
V
V
V
V
"}
(9,1,2) = {"
X
n
K
n
V
V
V
Y
K
K
K
W
y
V
V
V
V
V
V
K
K
V
V
V
V
V
V
V
V
V
"}
(10,1,2) = {"
y
X
K
n
V
V
V
Y
K
K
U
U
V
V
V
V
V
V
V
K
H
y
V
V
V
V
V
V
V
V
"}
(11,1,2) = {"
y
X
n
K
y
y
V
Y
K
K
U
V
V
V
M
V
V
V
V
y
K
L
y
V
V
V
V
V
V
V
"}
(12,1,2) = {"
V
V
V
K
K
R
y
Y
n
K
V
V
V
V
V
V
V
V
V
y
K
y
V
V
V
V
V
V
V
V
"}
(13,1,2) = {"
V
V
V
K
K
K
V
V
K
K
K
Y
Y
Y
Y
y
y
y
V
y
K
V
V
V
V
V
V
V
V
V
"}
(14,1,2) = {"
V
V
V
V
n
K
V
V
n
K
K
K
w
d
y
y
y
V
V
y
K
V
V
V
V
V
V
V
V
V
"}
(15,1,2) = {"
y
V
V
Y
n
H
y
V
X
X
n
n
n
y
y
V
V
V
U
K
K
V
V
V
V
V
V
V
V
V
"}
(16,1,2) = {"
K
V
V
Y
K
K
y
V
y
y
y
V
V
V
V
V
V
U
U
K
K
V
V
V
V
V
V
V
V
V
"}
(17,1,2) = {"
K
K
L
K
K
K
V
V
V
V
V
V
V
V
V
V
U
U
K
K
K
V
V
V
V
V
V
V
V
V
"}
(18,1,2) = {"
Y
n
K
K
n
Y
V
V
V
V
V
V
V
V
V
y
K
L
K
K
V
V
V
V
V
V
V
V
V
V
"}
(19,1,2) = {"
V
V
m
n
n
V
V
V
V
V
V
z
K
K
K
K
K
K
K
y
V
V
V
V
V
V
V
V
V
V
"}
(20,1,2) = {"
V
V
V
V
V
V
V
V
V
y
W
b
K
K
K
K
K
K
y
V
V
V
V
V
V
V
V
V
V
V
"}
(21,1,2) = {"
V
V
V
V
V
V
V
V
V
y
D
K
K
K
K
b
b
V
V
V
V
V
V
V
V
V
V
V
V
V
"}
(22,1,2) = {"
V
V
V
V
V
V
V
V
U
K
K
K
H
K
W
U
V
V
V
V
V
V
V
V
V
V
V
V
V
V
"}
(23,1,2) = {"
V
V
V
V
V
V
V
V
U
K
K
K
K
b
y
V
V
V
V
V
V
V
V
V
V
V
V
V
V
V
"}
(24,1,2) = {"
V
V
V
V
V
V
V
V
U
K
K
K
K
K
y
V
V
V
V
V
V
V
V
V
V
V
V
V
V
V
"}
(25,1,2) = {"
V
V
V
V
V
V
V
t
K
b
H
L
K
A
V
V
V
V
V
V
V
U
V
V
y
W
W
W
W
y
"}
(26,1,2) = {"
V
V
V
V
V
V
J
f
K
K
K
K
K
V
V
V
V
V
V
R
W
b
K
K
f
f
f
K
b
b
"}
(27,1,2) = {"
V
V
V
V
V
J
J
K
K
K
K
K
K
V
V
V
V
U
H
f
K
L
K
K
K
K
K
f
f
f
"}
(28,1,2) = {"
U
W
y
t
f
f
K
K
K
K
b
K
K
V
V
U
U
K
K
f
f
f
H
K
K
V
y
R
A
f
"}
(29,1,2) = {"
y
b
D
L
K
K
b
b
K
K
H
y
V
V
V
j
K
K
K
A
K
f
V
V
V
V
V
y
q
A
"}
(30,1,2) = {"
K
K
K
K
K
K
K
K
f
f
y
y
V
V
V
K
K
K
G
G
V
V
V
V
V
V
V
V
V
G
"}
