"aa" = (/turf/simulated/floor/tiled/steel,/area/awaymission)
"ab" = (/obj/random/pack/tech_loot/low_chance,/turf/simulated/floor/tiled/steel,/area/awaymission)
"ac" = (/obj/random/junk/low_chance,/turf/simulated/floor/tiled/steel,/area/awaymission)
"ad" = (/obj/structure/table/steel_reinforced,/obj/random/junk/low_chance,/turf/simulated/floor/tiled/white/techfloor,/area/awaymission)
"ae" = (/obj/structure/table/steel_reinforced,/obj/random/junk/low_chance,/turf/simulated/floor/tiled/steel,/area/awaymission)
"af" = (/obj/machinery/light/small,/turf/simulated/floor/tiled/steel,/area/awaymission)
"ag" = (/obj/structure/table/rack/shelf,/obj/random/firstaid/low_chance,/obj/random/firstaid/low_chance,/obj/random/firstaid/low_chance,/obj/machinery/light/small{dir = 1},/turf/simulated/floor/tiled/steel/monofloor,/area/awaymission)
"ah" = (/obj/structure/table/steel_reinforced,/turf/simulated/floor/tiled/steel,/area/awaymission)
"ai" = (/obj/effect/decal/cleanable/blood/gibs/body,/obj/random/junk/low_chance,/turf/simulated/floor/tiled/steel,/area/awaymission)
"aj" = (/obj/random/lowkeyrandom/low_chance,/turf/simulated/floor/tiled/steel,/area/awaymission)
"ak" = (/obj/random/pack/tech_loot/low_chance,/turf/simulated/floor/tiled/white/techfloor,/area/awaymission)
"al" = (/obj/structure/table/steel_reinforced,/obj/random/lathe_disk/advanced/low_chance,/turf/simulated/floor/tiled/steel/monofloor,/area/awaymission)
"am" = (/obj/structure/salvageable/console_os,/turf/simulated/floor/tiled/steel,/area/awaymission)
"an" = (/obj/effect/floor_decal/industrial/warning,/turf/simulated/floor/tiled/steel/panels,/area/awaymission)
"ao" = (/obj/effect/floor_decal/industrial/warning{dir = 1},/turf/simulated/floor/tiled/steel/panels,/area/awaymission)
"ap" = (/obj/random/pack/machine,/obj/machinery/light/small{dir = 1},/turf/simulated/floor/tiled/steel/monofloor,/area/awaymission)
"aq" = (/obj/random/pack/machine,/turf/simulated/floor/tiled/steel/monofloor,/area/awaymission)
"ar" = (/obj/random/pack/machine/low_chance,/obj/machinery/light/small{dir = 1},/turf/simulated/floor/tiled/steel,/area/awaymission)
"as" = (/obj/structure/salvageable/server_os,/turf/simulated/floor/tiled/steel/monofloor,/area/awaymission)
"at" = (/obj/machinery/door/airlock/vault{name = "Laboratory 2"},/turf/simulated/floor/tiled/steel,/area/awaymission)
"au" = (/obj/effect/decal/cleanable/blood/splatter,/turf/simulated/floor/tiled/steel,/area/awaymission)
"av" = (/turf/simulated/floor/tiled/steel/bar_flat,/area/awaymission)
"aw" = (/obj/effect/floor_decal/industrial/warning,/turf/simulated/wall/ironplasma,/area/awaymission)
"ax" = (/obj/effect/floor_decal/rust,/turf/simulated/floor/tiled/steel/bar_dance,/area/awaymission)
"ay" = (/turf/simulated/floor/tiled/steel/monofloor,/area/awaymission)
"az" = (/obj/structure/table/steel_reinforced,/turf/simulated/floor/tiled/steel/monofloor,/area/awaymission)
"aA" = (/obj/random/pack/machine/low_chance,/turf/simulated/floor/tiled/steel,/area/awaymission)
"aB" = (/obj/machinery/light/small{dir = 8},/turf/simulated/floor/tiled/steel,/area/awaymission)
"aC" = (/obj/effect/window_lwall_spawn/plasma/reinforced,/turf/simulated/floor/tiled/steel,/area/awaymission)
"aD" = (/obj/effect/floor_decal/industrial/warning{dir = 8},/obj/effect/decal/cleanable/blood/splatter,/turf/simulated/floor/tiled/white/techfloor_grid,/area/awaymission)
"aE" = (/obj/random/pack/tech_loot/low_chance,/turf/simulated/floor/tiled/steel/bar_flat,/area/awaymission)
"aF" = (/obj/effect/damagedfloor/rust,/turf/simulated/floor/tiled/steel/bar_flat,/area/awaymission)
"aG" = (/obj/random/pack/tech_loot/low_chance,/turf/simulated/floor/tiled/steel/monofloor,/area/awaymission)
"aH" = (/obj/structure/salvageable/computer_os,/turf/simulated/floor/tiled/white/techfloor_grid,/area/awaymission)
"aI" = (/obj/structure/salvageable/computer_os{dir = 6},/turf/simulated/floor/tiled/white/techfloor_grid,/area/awaymission)
"aJ" = (/turf/simulated/floor/tiled/steel/bar_dance,/area/awaymission)
"aK" = (/obj/effect/floor_decal/industrial/warning{dir = 8},/turf/simulated/floor/tiled/white/techfloor_grid,/area/awaymission)
"aL" = (/obj/structure/table/steel_reinforced,/obj/random/lowkeyrandom/low_chance,/turf/simulated/floor/tiled/steel,/area/awaymission)
"aM" = (/obj/effect/floor_decal/industrial/warning{dir = 1},/turf/simulated/wall/ironplasma,/area/awaymission)
"aN" = (/obj/effect/decal/cleanable/blood/splatter,/turf/simulated/floor/tiled/steel/monofloor,/area/awaymission)
"aO" = (/obj/effect/decal/cleanable/blood/splatter,/turf/simulated/floor/tiled/white/techfloor,/area/awaymission)
"aP" = (/obj/structure/salvageable/data_os,/turf/simulated/floor/tiled/steel/monofloor,/area/awaymission)
"aQ" = (/obj/machinery/light/small{dir = 4; pixel_y = 0},/obj/random/junk/low_chance,/turf/simulated/floor/tiled/steel,/area/awaymission)
"aR" = (/obj/machinery/door/airlock/centcom,/turf/simulated/floor/tiled/steel,/area/awaymission)
"aS" = (/obj/effect/floor_decal/industrial/warning{dir = 6},/turf/simulated/wall/ironplasma,/area/awaymission)
"aT" = (/turf/simulated/wall/ironplasma,/area/awaymission)
"aU" = (/obj/structure/salvageable/autolathe,/turf/simulated/floor/tiled/steel/monofloor,/area/awaymission)
"aV" = (/obj/structure/table/steel_reinforced,/obj/random/junk/low_chance,/turf/simulated/floor/tiled/steel/monofloor,/area/awaymission)
"aW" = (/obj/random/cluster/psi_monster/lower_chance,/turf/simulated/floor/tiled/steel/monofloor,/area/awaymission)
"aX" = (/turf/simulated/wall/r_wall,/area/awaymission)
"aY" = (/turf/simulated/floor/tiled/white/techfloor,/area/awaymission)
"aZ" = (/obj/effect/damagedfloor/rust,/turf/simulated/floor/tiled/steel/bar_dance,/area/awaymission)
"ba" = (/obj/random/cluster/psi_monster/lower_chance,/turf/simulated/floor/tiled/steel,/area/awaymission)
"bb" = (/obj/effect/floor_decal/industrial/warning,/obj/random/pack/machine,/turf/simulated/floor/tiled/steel/panels,/area/awaymission)
"bc" = (/obj/random/junk/low_chance,/obj/machinery/light/small{dir = 1},/turf/simulated/floor/tiled/white/techfloor,/area/awaymission)
"bd" = (/obj/random/pack/machine/low_chance,/obj/machinery/light/small{dir = 4; pixel_y = 0},/turf/simulated/floor/tiled/steel,/area/awaymission)
"be" = (/obj/random/pack/machine/low_chance,/obj/machinery/light/small{dir = 8},/turf/simulated/floor/tiled/white/techfloor,/area/awaymission)
"bf" = (/obj/effect/floor_decal/industrial/warning{dir = 8},/obj/effect/decal/cleanable/blood/gibs/body,/obj/machinery/light/small{dir = 8},/turf/simulated/floor/tiled/white/techfloor_grid,/area/awaymission)
"bg" = (/obj/random/junk/cigbutt,/turf/simulated/floor/tiled/white/techfloor,/area/awaymission)
"bh" = (/obj/machinery/light/small{dir = 8},/turf/simulated/floor/tiled/steel/bar_dance,/area/awaymission)
"bi" = (/obj/effect/floor_decal/rust,/obj/random/cluster/psi_monster,/turf/simulated/floor/tiled/steel/bar_flat,/area/awaymission)
"bj" = (/obj/random/furniture/pottedplant,/turf/simulated/floor/tiled/steel/bar_flat,/area/awaymission)
"bk" = (/obj/structure/bed/chair{dir = 8},/turf/simulated/floor/tiled/white/techfloor,/area/awaymission)
"bl" = (/obj/effect/floor_decal/industrial/warning{dir = 8},/obj/machinery/light/small{dir = 8},/turf/simulated/floor/tiled/white/techfloor_grid,/area/awaymission)
"bm" = (/obj/effect/decal/cleanable/blood/gibs/body,/obj/random/pack/tech_loot,/obj/machinery/light/small{dir = 8},/turf/simulated/floor/tiled/white/techfloor,/area/awaymission)
"bn" = (/obj/random/pack/tech_loot,/turf/simulated/floor/tiled/steel,/area/awaymission)
"bo" = (/obj/machinery/light/small{dir = 4; pixel_y = 0},/turf/simulated/floor/tiled/steel,/area/awaymission)
"bp" = (/obj/effect/floor_decal/industrial/warning{dir = 1},/obj/random/pack/gun_loot,/turf/simulated/floor/tiled/steel/panels,/area/awaymission)
"bq" = (/obj/effect/floor_decal/industrial/warning{dir = 1},/obj/random/closet_tech/low_chance,/turf/simulated/floor/tiled/steel/panels,/area/awaymission)
"br" = (/obj/machinery/light/small,/turf/simulated/floor/tiled/white/techfloor,/area/awaymission)
"bs" = (/obj/random/pack/tech_loot/low_chance,/obj/random/pack/gun_loot,/turf/simulated/floor/tiled/steel/monofloor,/area/awaymission)
"bt" = (/obj/structure/table/steel_reinforced,/obj/random/gun_energy_cheap/low_chance,/obj/random/ammo_lowcost/low_chance,/obj/random/ammo_lowcost/low_chance,/turf/simulated/floor/tiled/steel/monofloor,/area/awaymission)
"bu" = (/obj/random/closet_tech/low_chance,/turf/simulated/floor/tiled/steel/monofloor,/area/awaymission)
"bv" = (/obj/random/closet_maintloot/low_chance,/turf/simulated/floor/tiled/steel/monofloor,/area/awaymission)
"bw" = (/obj/effect/decal/cleanable/blood/splatter,/obj/random/closet_maintloot/low_chance,/turf/simulated/floor/tiled/steel/monofloor,/area/awaymission)
"bx" = (/obj/structure/table/steel_reinforced,/obj/random/junk/low_chance,/obj/machinery/light/small,/turf/simulated/floor/tiled/steel/monofloor,/area/awaymission)
"by" = (/obj/structure/table/steel_reinforced,/obj/random/ammo_fancy,/obj/random/ammo_fancy,/obj/random/ammo/low_chance,/turf/simulated/floor/tiled/steel/monofloor,/area/awaymission)
"bz" = (/obj/structure/table/steel_reinforced,/obj/random/firstaid,/turf/simulated/floor/tiled/steel/monofloor,/area/awaymission)
"bA" = (/obj/structure/table/steel_reinforced,/obj/random/ammo/shotgun/low_chance,/obj/random/ammo/shotgun/low_chance,/obj/random/ammo_fancy/low_chance,/obj/random/ammo_fancy/low_chance,/turf/simulated/floor/tiled/steel/monofloor,/area/awaymission)
"bB" = (/obj/machinery/light/small,/turf/simulated/floor/tiled/steel/monofloor,/area/awaymission)
"bC" = (/obj/structure/table/steel_reinforced,/obj/random/junk/low_chance,/obj/machinery/light/small,/turf/simulated/floor/tiled/steel,/area/awaymission)
"bD" = (/obj/random/pack/rare,/turf/simulated/floor/tiled/steel,/area/awaymission)
"bE" = (/obj/machinery/light/small{dir = 1},/turf/simulated/floor/tiled/steel,/area/awaymission)

(1,1,1) = {"
aaaaaaacacacacaaaaaaaaaaaaacacacacaaacacaa
acaaaaaaaaafaaaaaaacacaaafaaaaaaaaaaaaaaaa
acaaaXaXaXaXaXaXaXaXaXaXaXaXaXaXaXaXaXaaaa
aaaaaXaPazagazaValapaUaqaTaharaeaAamaXaaaa
aaacaXaNayayayayayayayayaRaaaaauaaaAaXaBac
aaaQaXayaGaWaNayaTaTaTaTaTaAbaaaaaaAaXaaaa
aaaaaXbbananananawaYbcaYaRauaaaaaaaLaXacaa
aaaaaXaTaCaCaCaCaTaKaYaOaTaTaTaTaabdaXacaa
aaacaXaTaJaJaJaZaCaKaYaTaTbeaAaiaaaAaXaaaa
acaaaXaTaJavavaxaTbfaYaCaIbgaaaaaXaXaXaBaa
acaaaXaTbhbibjaJataDaYaCaHbkaaauataaataaaa
acaaaXaTaJaEaFaJaTblaYaCaHbgaaaaaXaXaXaBaa
aaaaaXaTaJaJaJaxaCaKaYaTaTbmbnaaaaaaaXaaaa
aaaaaXaTaCaCaCaCaSaKaYakaTaTaTaTaaboaXaaac
acacaXbpaoaoaobqaMadbraYaRaaaaaaajaaaXaaac
acboaXbsaybtaNbuaTaTaTaTaTaabaauaaaaaXaaaa
aaaaaXbvayayaWayayayayayaRaaaaaaaaabaXaBaa
acaaaXbwaybxbybzbAbBasayaTahbCahbDbDaXaaaa
aaaaaXaXaXaXaXaXaXaXaXaXaXaXaXaXaXaXaXaaaa
aaaaaaaaaabEacaaaaaaaaaabEaaacacacaaaaacac
acacaaaaacacaaaaacacacaaaaaaaaaaacacacacaa
"}
