"a" = (/turf/simulated/floor/tiled/dark,/area/deepmaint)
"b" = (/turf/simulated/floor/fixed/fgrass,/area/deepmaint)
"c" = (/obj/structure/flora/ausbushes/lavendergrass,/obj/structure/flora/ausbushes/brflowers,/obj/structure/flora/ausbushes/ywflowers,/obj/item/ammo_casing,/obj/effect/decal/cleanable/blood/gibs,/turf/simulated/floor/fixed/fgrass,/area/deepmaint)
"d" = (/obj/structure/flora/small/grassa2,/turf/simulated/floor/fixed/fgrass,/area/deepmaint)
"e" = (/turf/simulated/floor/beach/water/jungle,/area/deepmaint)
"f" = (/obj/item/ammo_casing,/obj/item/ammo_casing,/obj/effect/decal/cleanable/blood,/turf/simulated/floor/fixed/fgrass,/area/deepmaint)
"g" = (/obj/machinery/light{dir = 1},/turf/simulated/floor/fixed/fgrass,/area/deepmaint)
"h" = (/obj/structure/flora/small/grassb5,/obj/item/ammo_casing,/turf/simulated/floor/fixed/fgrass,/area/deepmaint)
"i" = (/obj/item/ammo_casing,/obj/effect/decal/cleanable/blood,/turf/simulated/floor/fixed/fgrass,/area/deepmaint)
"j" = (/turf/simulated/floor/beach/water/jungledeep,/area/deepmaint)
"k" = (/obj/structure/salvageable/console_broken_os,/obj/effect/decal/cleanable/blood/gibs,/turf/simulated/floor/fixed/fgrass,/area/deepmaint)
"l" = (/obj/structure/salvageable/server_os,/turf/simulated/floor/fixed/fgrass,/area/deepmaint)
"m" = (/obj/machinery/light/small,/turf/simulated/floor/tiled/dark,/area/deepmaint)
"n" = (/obj/structure/flora/ausbushes/fullgrass,/turf/simulated/floor/fixed/fgrass,/area/deepmaint)
"o" = (/obj/structure/flora/small/grassb3,/obj/effect/decal/cleanable/blood,/turf/simulated/floor/fixed/fgrass,/area/deepmaint)
"p" = (/obj/machinery/light_construct{dir = 4},/turf/simulated/floor/fixed/fgrass,/area/deepmaint)
"q" = (/obj/structure/flora/small/grassa5,/obj/item/ammo_casing,/turf/simulated/floor/fixed/fgrass,/area/deepmaint)
"r" = (/obj/machinery/light/small{dir = 4; pixel_y = 0},/turf/simulated/floor/tiled/dark,/area/deepmaint)
"s" = (/obj/item/ammo_casing,/turf/simulated/floor/fixed/fgrass,/area/deepmaint)
"t" = (/obj/structure/flora/small/grassb5,/obj/item/ammo_casing,/obj/item/ammo_casing,/obj/item/ammo_casing,/obj/item/ammo_casing,/turf/simulated/floor/fixed/fgrass,/area/deepmaint)
"u" = (/obj/structure/flora/small/grassb5,/obj/structure/flora/small/grassb3,/turf/simulated/floor/fixed/fgrass,/area/deepmaint)
"v" = (/obj/structure/flora/tree/jungle,/turf/simulated/floor/beach/water/jungledeep,/area/deepmaint)
"w" = (/obj/structure/flora/ausbushes/lavendergrass,/obj/structure/flora/ausbushes/brflowers,/obj/structure/flora/ausbushes/ywflowers,/turf/simulated/floor/fixed/fgrass,/area/deepmaint)
"x" = (/obj/machinery/light{dir = 4; icon_state = "tube1"},/turf/simulated/floor/fixed/fgrass,/area/deepmaint)
"y" = (/obj/item/ammo_casing,/obj/item/ammo_casing,/turf/simulated/floor/fixed/fgrass,/area/deepmaint)
"z" = (/obj/machinery/light/small{dir = 8},/turf/simulated/floor/tiled/dark,/area/deepmaint)
"A" = (/obj/structure/flora/small/grassa3,/turf/simulated/floor/fixed/fgrass,/area/deepmaint)
"B" = (/obj/structure/flora/small/grassb1,/turf/simulated/floor/fixed/fgrass,/area/deepmaint)
"C" = (/obj/structure/flora/small/grassa2,/obj/item/ammo_casing,/obj/item/ammo_casing,/obj/item/ammo_casing,/turf/simulated/floor/fixed/fgrass,/area/deepmaint)
"D" = (/turf/unsimulated/wall/jungle,/area/deepmaint)
"E" = (/obj/random/cluster/psi_monster/lower_chance,/turf/simulated/floor/beach/water/jungle,/area/deepmaint)
"F" = (/obj/machinery/door/airlock/vault{name = "Laboratory 5"},/turf/simulated/floor/fixed/fgrass,/area/deepmaint)
"G" = (/obj/effect/decal/cleanable/blood,/turf/simulated/floor/fixed/fgrass,/area/deepmaint)
"H" = (/obj/structure/flora/small/grassb2,/turf/simulated/floor/fixed/fgrass,/area/deepmaint)
"I" = (/obj/structure/flora/small/grassb1,/obj/item/ammo_casing,/obj/item/ammo_casing,/obj/item/ammo_casing,/obj/item/ammo_casing,/turf/simulated/floor/fixed/fgrass,/area/deepmaint)
"J" = (/turf/simulated/wall/r_wall,/area/deepmaint)
"K" = (/obj/structure/flora/small/grassb3,/turf/simulated/floor/fixed/fgrass,/area/deepmaint)
"L" = (/obj/machinery/light{dir = 8},/turf/simulated/floor/fixed/fgrass,/area/deepmaint)
"M" = (/obj/structure/flora/ausbushes/lavendergrass,/turf/simulated/floor/fixed/fgrass,/area/deepmaint)
"N" = (/obj/structure/salvageable/computer_os,/turf/simulated/floor/fixed/fgrass,/area/deepmaint)
"O" = (/obj/structure/flora/small/grassa5,/turf/simulated/floor/fixed/fgrass,/area/deepmaint)
"P" = (/obj/structure/salvageable/data_os,/turf/simulated/floor/fixed/fgrass,/area/deepmaint)
"Q" = (/obj/random/cluster/psi_monster/lower_chance,/turf/simulated/floor/tiled/dark,/area/deepmaint)
"S" = (/obj/structure/flora/ausbushes/grassybush,/turf/simulated/floor/fixed/fgrass,/area/deepmaint)
"T" = (/obj/structure/flora/ausbushes/lavendergrass,/obj/structure/flora/ausbushes/brflowers,/obj/structure/flora/ausbushes/ywflowers,/obj/effect/decal/cleanable/blood/gibs,/turf/simulated/floor/fixed/fgrass,/area/deepmaint)
"U" = (/obj/structure/flora/small/grassb5,/obj/item/ammo_casing,/obj/item/ammo_casing,/turf/simulated/floor/fixed/fgrass,/area/deepmaint)
"V" = (/obj/structure/flora/small/grassb1,/obj/structure/flora/small/grassb3,/turf/simulated/floor/fixed/fgrass,/area/deepmaint)
"W" = (/obj/structure/flora/small/grassa4,/turf/simulated/floor/fixed/fgrass,/area/deepmaint)
"X" = (/obj/structure/flora/tree/jungle/variant2,/turf/simulated/floor/fixed/fgrass,/area/deepmaint)
"Y" = (/obj/structure/flora/small/grassb5,/turf/simulated/floor/fixed/fgrass,/area/deepmaint)
"Z" = (/obj/structure/flora/small/grassa2,/obj/item/ammo_casing,/turf/simulated/floor/fixed/fgrass,/area/deepmaint)

(1,1,1) = {"
aaaaaaaaaaaaaaaaaaaaa
aaaaamaaaaaaamaaaaaaa
aaJJJJJJJJJJJJFFJJJaa
aaJbdbbbgbdbbDbbbxJaa
arJbDDDDDDDDbDbDDtJza
aaJObbbDObGDqDHbDfJaa
aaJDDDGDbDZssDDDDbJaa
aaJbbsbDYDDDsnbGDsJaa
aaJADDDDbbbDDDDbyUJaa
aaJZDYhoubVKMBDDDDJaa
arJLDDDDDDDDDMWdbxJza
aaJbDbbsTXTPDDDDdBJaa
aaJsDiDbwccNDbICWbJaa
aaJAbbDDDDDDDbDDDDJaa
aaJDDDDsbeejeebbbbJaa
aaJbbbbeeEjjjeeSlpJaa
arJLGkbeDjjvjDeGbbJza
aaJbSbbGDDDDDDbbbbJaa
aaJJJJJJJJJJJJJJJJJaa
aaaaaaaaaaQaaaaaaaaaa
aaaaaaaaaaaaaaaaaaaaa
"}
