"aa" = (/turf/simulated/wall/r_wall,/area/deepmaint)
"ab" = (/obj/machinery/chem_master,/turf/simulated/floor/tiled/white,/area/deepmaint)
"ac" = (/obj/item/stock_parts/capacitor,/turf/simulated/floor/tiled/white,/area/deepmaint)
"ad" = (/obj/effect/floor_decal/industrial/loading/white{dir = 4},/turf/simulated/floor/tiled/dark,/area/deepmaint)
"ae" = (/obj/effect/floor_decal/industrial/botleft,/turf/simulated/floor/tiled/dark,/area/deepmaint)
"af" = (/obj/structure/table/woodentable,/obj/item/paper_bin,/obj/item/pen,/obj/random/psi_megafauna,/turf/simulated/floor/wood,/area/deepmaint)
"ag" = (/obj/structure/table/reinforced,/obj/effect/decal/cleanable/blood/splatter,/obj/random/firstaid/low_chance,/obj/random/firstaid/low_chance,/turf/simulated/floor/tiled/white,/area/deepmaint)
"ah" = (/obj/item/material/shard,/turf/simulated/floor/tiled/steel/techfloor,/area/deepmaint)
"ai" = (/obj/random/medical_lowcost/low_chance,/turf/simulated/floor/tiled/dark,/area/deepmaint)
"aj" = (/obj/structure/table/reinforced,/obj/item/storage/box/syringes,/obj/item/storage/box/beakers,/obj/random/oddity_guns,/turf/simulated/floor/tiled/white,/area/deepmaint)
"ak" = (/obj/structure/table/reinforced,/obj/machinery/reagentgrinder,/obj/item/material/shard,/obj/item/circuitboard/chemical_dispenser,/turf/simulated/floor/tiled/white,/area/deepmaint)
"al" = (/obj/random/cluster/psi_monster/low_chance,/turf/simulated/floor/tiled/white,/area/deepmaint)
"am" = (/obj/machinery/body_scanconsole,/turf/simulated/floor/tiled/dark/gray_perforated,/area/deepmaint)
"an" = (/obj/effect/floor_decal/industrial/botright,/turf/simulated/floor/tiled/dark,/area/deepmaint)
"ao" = (/obj/item/stock_parts/manipulator,/turf/simulated/floor/tiled/dark/gray_perforated,/area/deepmaint)
"ap" = (/obj/structure/table/reinforced,/obj/item/pen,/obj/item/paper_bin,/obj/item/stock_parts/console_screen,/obj/item/oddity/common/old_id,/turf/simulated/floor/tiled/white,/area/deepmaint)
"aq" = (/obj/structure/table/reinforced,/obj/structure/windoor_assembly{dir = 2},/obj/structure/windoor_assembly,/obj/item/material/shard,/obj/effect/decal/cleanable/blood/gibs/xeno,/turf/simulated/floor/tiled/white,/area/deepmaint)
"ar" = (/obj/structure/table/glass,/obj/item/storage/freezer/medical,/obj/item/cell/medium/high,/turf/simulated/floor/tiled/steel/techfloor,/area/deepmaint)
"as" = (/obj/structure/closet/secure_closet/freezer/blood,/obj/item/stock_parts/matter_bin,/obj/item/stock_parts/matter_bin,/turf/simulated/floor/tiled/steel/techfloor,/area/deepmaint)
"at" = (/obj/random/cluster/psi_monster/low_chance,/turf/simulated/floor/tiled/steel,/area/deepmaint)
"au" = (/obj/machinery/smartfridge,/turf/simulated/floor/tiled/dark/gray_perforated,/area/deepmaint)
"av" = (/obj/structure/low_wall,/obj/item/material/shard,/obj/item/material/shard,/turf/simulated/floor/tiled/dark/gray_perforated,/area/deepmaint)
"aw" = (/obj/structure/low_wall,/obj/item/material/shard,/obj/item/material/shard,/obj/item/material/shard,/turf/simulated/floor/tiled/dark/gray_perforated,/area/deepmaint)
"ax" = (/obj/effect/window_lwall_spawn/smartspawn,/turf/simulated/floor/tiled/dark/gray_perforated,/area/deepmaint)
"bN" = (/obj/effect/decal/cleanable/blood/gibs,/turf/simulated/floor/tiled/steel/techfloor,/area/deepmaint)
"bW" = (/obj/effect/decal/cleanable/blood/drip,/obj/machinery/light{dir = 8},/obj/structure/girder,/turf/simulated/floor/tiled/white,/area/deepmaint)
"cc" = (/obj/effect/decal/cleanable/blood/drip,/obj/effect/decal/cleanable/blood/gibs/xeno,/turf/simulated/floor/tiled/dark,/area/deepmaint)
"ch" = (/obj/effect/decal/cleanable/blood/splatter,/obj/machinery/light{dir = 4; icon_state = "tube1"},/turf/simulated/floor/tiled/white,/area/deepmaint)
"dc" = (/obj/structure/table/glass,/obj/item/storage/firstaid/surgery,/turf/simulated/floor/tiled/steel/techfloor,/area/deepmaint)
"dw" = (/obj/structure/filingcabinet/filingcabinet,/turf/simulated/floor/tiled/white,/area/deepmaint)
"dy" = (/obj/structure/closet/secure_closet/freezer/blood,/turf/simulated/floor/tiled/steel/techfloor,/area/deepmaint)
"dT" = (/obj/effect/decal/cleanable/blood/splatter,/obj/machinery/light{dir = 8},/turf/simulated/floor/tiled/white,/area/deepmaint)
"ep" = (/obj/effect/decal/cleanable/blood/splatter,/turf/simulated/floor/wood,/area/deepmaint)
"fa" = (/turf/simulated/floor/tiled/white,/area/deepmaint)
"gu" = (/obj/effect/decal/cleanable/blood/writing{desc = "It looks like a writing in blood. It says: ''NOT SAFE ANYWHERE!''."},/turf/simulated/floor/tiled/white,/area/deepmaint)
"gL" = (/turf/simulated/floor/tiled/steel/techfloor,/area/deepmaint)
"in" = (/obj/machinery/door/firedoor,/obj/effect/decal/cleanable/blood,/obj/effect/decal/cleanable/blood/tracks,/turf/simulated/floor/tiled/white,/area/deepmaint)
"jt" = (/obj/machinery/optable,/obj/effect/decal/cleanable/blood,/obj/effect/decal/cleanable/blood/gibs,/turf/simulated/floor/tiled/steel/techfloor,/area/deepmaint)
"jB" = (/obj/effect/decal/cleanable/blood/drip,/obj/effect/decal/cleanable/blood/gibs/xeno,/turf/simulated/floor/tiled/white,/area/deepmaint)
"jF" = (/obj/structure/girder,/turf/simulated/floor/tiled/white,/area/deepmaint)
"kI" = (/obj/structure/firedoor_assembly,/turf/simulated/floor/tiled/white,/area/deepmaint)
"lN" = (/obj/effect/decal/cleanable/blood/tracks,/turf/simulated/floor/tiled/white,/area/deepmaint)
"mr" = (/obj/effect/decal/cleanable/blood/gibs/body,/turf/simulated/floor/tiled/white,/area/deepmaint)
"my" = (/obj/structure/filingcabinet/filingcabinet,/turf/simulated/floor/wood,/area/deepmaint)
"mX" = (/obj/structure/bed/chair/comfy/black,/obj/effect/decal/cleanable/blood/splatter,/turf/simulated/floor/wood,/area/deepmaint)
"nv" = (/turf/simulated/floor/tiled/dark/gray_perforated,/area/deepmaint)
"pc" = (/obj/structure/table/glass,/obj/random/medical,/obj/random/medical,/obj/random/medical/low_chance,/obj/random/medical/low_chance,/obj/random/medical/low_chance,/obj/random/medical/low_chance,/obj/random/medical/low_chance,/turf/simulated/floor/tiled/steel/techfloor,/area/deepmaint)
"ph" = (/obj/machinery/vending/wallmed/lobby{pixel_x = -25},/obj/effect/decal/cleanable/blood,/turf/simulated/floor/tiled/white,/area/deepmaint)
"pB" = (/turf/simulated/wall,/area/deepmaint)
"qe" = (/obj/effect/decal/cleanable/blood/splatter,/obj/effect/decal/cleanable/blood/gibs/xeno/body,/obj/item/frame/light{dir = 4; pixel_x = 15},/obj/item/material/shard,/obj/random/medical_lowcost/low_chance,/turf/simulated/floor/tiled/white,/area/deepmaint)
"qq" = (/obj/effect/decal/cleanable/blood/drip,/obj/structure/barricade,/turf/simulated/floor/tiled/white,/area/deepmaint)
"qW" = (/obj/machinery/constructable_frame/machine_frame,/turf/simulated/floor/tiled/white,/area/deepmaint)
"uc" = (/obj/machinery/door/blast/regular,/turf/simulated/floor/tiled/white,/area/deepmaint)
"uZ" = (/obj/effect/decal/cleanable/blood/splatter,/turf/simulated/floor/tiled/white,/area/deepmaint)
"vC" = (/turf/simulated/floor/tiled/steel/brown_perforated,/area/deepmaint)
"vP" = (/obj/structure/bed/chair{dir = 4},/turf/simulated/floor/wood,/area/deepmaint)
"wp" = (/obj/effect/decal/cleanable/blood/gibs/xeno/body,/turf/simulated/floor/tiled/white,/area/deepmaint)
"wq" = (/obj/structure/sign/medsci/bluecross2,/turf/simulated/wall,/area/deepmaint)
"wU" = (/obj/machinery/door/blast/regular/open,/obj/effect/decal/cleanable/blood,/turf/simulated/floor/tiled/white,/area/deepmaint)
"xb" = (/obj/structure/bed/chair/office/dark,/turf/simulated/floor/tiled/white,/area/deepmaint)
"xq" = (/obj/machinery/vending/medical,/turf/simulated/floor/tiled/white,/area/deepmaint)
"xA" = (/obj/effect/decal/cleanable/blood/gibs/xeno,/turf/simulated/floor/tiled/white,/area/deepmaint)
"yi" = (/obj/machinery/door/airlock/command{name = "Chief Medical Officer"},/turf/simulated/floor/tiled/white,/area/deepmaint)
"yH" = (/obj/structure/table/woodentable,/obj/item/device/lighting/toggleable/lamp/green,/turf/simulated/floor/wood,/area/deepmaint)
"zm" = (/obj/machinery/light{dir = 8},/obj/random/medical_lowcost/low_chance,/turf/simulated/floor/tiled/white,/area/deepmaint)
"zr" = (/obj/effect/decal/cleanable/blood/gibs,/turf/simulated/floor/tiled/steel/brown_perforated,/area/deepmaint)
"zu" = (/obj/item/frame/light{pixel_y = -15},/obj/item/material/shard,/turf/simulated/floor/tiled/white,/area/deepmaint)
"zT" = (/obj/item/material/shard,/obj/effect/decal/cleanable/blood/gibs/xeno,/turf/simulated/floor/tiled/white,/area/deepmaint)
"Aw" = (/obj/machinery/light{dir = 1},/turf/simulated/floor/tiled/white,/area/deepmaint)
"AO" = (/obj/structure/bed/chair{dir = 4},/turf/simulated/floor/tiled/white,/area/deepmaint)
"Be" = (/obj/machinery/photocopier,/turf/simulated/floor/tiled/white,/area/deepmaint)
"CK" = (/obj/effect/decal/cleanable/blood/drip,/turf/simulated/floor/tiled/white,/area/deepmaint)
"Do" = (/obj/effect/decal/cleanable/blood/gibs/xeno/limb,/turf/simulated/floor/tiled/white,/area/deepmaint)
"Ej" = (/obj/machinery/light{dir = 4; icon_state = "tube1"},/turf/simulated/floor/tiled/dark/gray_platform,/area/deepmaint)
"Ev" = (/obj/effect/decal/cleanable/blood/splatter,/obj/random/medical_lowcost/low_chance,/turf/simulated/floor/tiled/white,/area/deepmaint)
"Ez" = (/obj/structure/table/glass,/obj/random/medical,/obj/random/medical,/obj/random/medical/low_chance,/obj/random/medical/low_chance,/obj/random/medical/low_chance,/obj/random/medical/low_chance,/turf/simulated/floor/tiled/steel/techfloor,/area/deepmaint)
"Go" = (/obj/effect/decal/cleanable/blood/drip,/obj/random/medical_lowcost/low_chance,/turf/simulated/floor/tiled/white,/area/deepmaint)
"Gp" = (/obj/machinery/door/airlock/glass_medical,/turf/simulated/floor/tiled/white,/area/deepmaint)
"Gs" = (/obj/structure/table/glass,/obj/item/storage/freezer/medical,/turf/simulated/floor/tiled/steel/techfloor,/area/deepmaint)
"GP" = (/obj/effect/decal/cleanable/blood/gibs/xeno,/turf/simulated/floor/tiled/steel/techfloor,/area/deepmaint)
"Id" = (/obj/random/medical_lowcost/low_chance,/turf/simulated/floor/tiled/white,/area/deepmaint)
"Iu" = (/obj/structure/bed/chair{dir = 8},/obj/machinery/light{dir = 4; icon_state = "tube1"},/turf/simulated/floor/tiled/white,/area/deepmaint)
"Jk" = (/obj/machinery/light{dir = 4; icon_state = "tube1"},/turf/simulated/floor/tiled/dark,/area/deepmaint)
"JJ" = (/obj/structure/bed/chair/office/dark,/obj/item/material/shard,/obj/item/material/shard,/obj/effect/decal/cleanable/blood,/turf/simulated/floor/tiled/white,/area/deepmaint)
"Ll" = (/obj/structure/medical_stand,/turf/simulated/floor/tiled/steel/techfloor,/area/deepmaint)
"LO" = (/turf/simulated/floor/tiled/dark,/area/deepmaint)
"Mu" = (/obj/effect/decal/cleanable/blood,/turf/simulated/floor/tiled/steel/brown_perforated,/area/deepmaint)
"MF" = (/obj/structure/door_assembly,/turf/simulated/floor/tiled/white,/area/deepmaint)
"Or" = (/obj/item/material/shard,/turf/simulated/floor/wood,/area/deepmaint)
"Qo" = (/obj/structure/bed/chair{dir = 4},/obj/machinery/light{dir = 8},/turf/simulated/floor/tiled/white,/area/deepmaint)
"Sa" = (/obj/effect/decal/cleanable/blood,/turf/simulated/floor/tiled/white,/area/deepmaint)
"Sj" = (/obj/effect/decal/cleanable/blood,/turf/simulated/floor/tiled/steel/techfloor,/area/deepmaint)
"SR" = (/obj/machinery/sleeper,/turf/simulated/floor/tiled/dark/gray_perforated,/area/deepmaint)
"SW" = (/turf/simulated/floor/tiled/steel,/area/deepmaint)
"Te" = (/obj/structure/bed/chair{dir = 8},/turf/simulated/floor/tiled/white,/area/deepmaint)
"UA" = (/obj/effect/decal/cleanable/blood/drip,/obj/structure/girder,/turf/simulated/floor/tiled/white,/area/deepmaint)
"UY" = (/obj/machinery/optable,/obj/effect/decal/cleanable/blood,/turf/simulated/floor/tiled/steel/techfloor,/area/deepmaint)
"Vy" = (/obj/structure/sign/directions/cryo{dir = 4},/turf/simulated/wall,/area/deepmaint)
"Wl" = (/obj/structure/barricade,/turf/simulated/floor/tiled/white,/area/deepmaint)
"WG" = (/turf/simulated/floor/wood,/area/deepmaint)
"Xh" = (/obj/structure/curtain/medical,/turf/simulated/floor/tiled/white,/area/deepmaint)
"XK" = (/obj/structure/showcase/horrific_experiment_cryo,/turf/simulated/floor/tiled/dark/gray_platform,/area/deepmaint)
"YS" = (/obj/effect/decal/cleanable/blood/drip,/obj/effect/decal/cleanable/blood/gibs/xeno/body,/turf/simulated/floor/tiled/white,/area/deepmaint)
"ZE" = (/obj/machinery/bodyscanner,/turf/simulated/floor/tiled/dark/gray_perforated,/area/deepmaint)
"ZZ" = (/obj/item/frame/light{dir = 1; pixel_y = 15},/obj/item/material/shard,/turf/simulated/floor/tiled/white,/area/deepmaint)

(1,1,1) = {"
SWSWSWSWSWSWSWSWSWSWSWSWSWSWSWSWSWSWSWSWSW
SWSWSWSWSWSWSWSWSWSWSWSWSWSWSWSWSWSWSWSWSW
SWSWaaaaaaaaaapBpBpBpBpBpBpBpBpBpBpBpBSWSW
SWSWaamymXWGaaabacuZaufaZZxqadSRaeSRpBSWSW
SWSWaayHafepaaqWxbagpBxAIdCKaiccLOJkpBSWSW
SWSWaavPOrOraaajuZakpBfafaaladZEamanpBSWSW
SWSWaaaayiavaapBGpawpBzmfafaVypBpBpBpBSWSW
SWSWpBdTfafaIdfaDofaAwjBfaGoxAXhaoXKpBSWSW
SWSWpBpBpBpBpBpBpBgujFWlWlCKfaXhnvEjpBSWSW
SWSWpBBefaAwdwdwpBWlIdCKfaIdfaXhnvXKpBSWSW
SWSWpBapfaJJzTfaMFuZCKjFchpBpBpBpBpBpBSWSW
SWSWpBpBaxaqaxpBpBIdfaYSfaaxgLdyEzarpBSWSW
SWSWpBphfafafafapBjFwpjFfaGpSjzrMudcpBSWSW
SWSWpBAOfafamrTepBqqCKuZUApBgLbNUYLlpBSWSW
SWSWpBQofaalfaIupBbWWlCKqepBpBpBpBpBpBSWSW
SWSWwqfafaSafafapBxAwpjFfaavahaspcGspBSWSW
SWSWucmrfafaCKuZkIfaEvYSCKGpgLvCMudcpBSWSW
SWSWucjBCKzulNlNinlNUAfachpBGPgLjtLlpBSWSW
SWSWpBwUucwqpBpBpBpBpBpBpBpBpBpBpBpBpBSWSW
SWatSWSWSWSWSWSWSWSWSWSWSWSWSWSWSWSWSWSWSW
SWSWSWSWSWSWSWSWSWSWSWSWSWSWSWSWSWSWSWSWSW
"}
