//MAP CONVERTED BY dmm2tgm.py THIS HEADER COMMENT PREVENTS RECONVERSION, DO NOT REMOVE
"al" = (
/obj/effect/floor_decal/industrial/warning,
/obj/machinery/light,
/turf/simulated/floor/tiled/steel,
/area/deepmaint)
"cq" = (
/obj/effect/floor_decal/industrial/warning{
	dir = 4
	},
/obj/machinery/light{
	dir = 4;
	icon_state = "tube1"
	},
/obj/machinery/smartfridge,
/turf/simulated/floor/tiled/steel,
/area/deepmaint)
"ct" = (
/obj/effect/floor_decal/industrial/warning,
/obj/effect/decal/cleanable/blood/gibs,
/obj/effect/damagedfloor/fire,
/turf/simulated/floor/tiled/steel,
/area/deepmaint)
"df" = (
/obj/effect/damagedfloor/fire,
/turf/simulated/floor/reinforced,
/area/deepmaint)
"ei" = (
/obj/effect/floor_decal/industrial/warning{
	dir = 4
	},
/obj/effect/damagedfloor/fire,
/turf/simulated/floor/tiled/steel,
/area/deepmaint)
"ey" = (
/obj/effect/damagedfloor/fire,
/turf/simulated/floor/tiled/steel,
/area/deepmaint)
"eF" = (
/obj/effect/decal/cleanable/mucus,
/turf/simulated/floor/reinforced,
/area/deepmaint)
"gB" = (
/obj/machinery/light{
	dir = 8
	},
/turf/simulated/floor/reinforced,
/area/deepmaint)
"it" = (
/obj/effect/floor_decal/industrial/warning{
	dir = 4
	},
/obj/structure/table/rack,
/obj/machinery/light{
	dir = 4;
	icon_state = "tube1"
	},
/obj/random/medical_lowcost/low_chance,
/obj/random/medical_lowcost/low_chance,
/obj/random/medical_lowcost/low_chance,
/obj/random/medical_lowcost/low_chance,
/obj/random/medical_lowcost/low_chance,
/obj/random/medical_lowcost/low_chance,
/obj/random/medical/low_chance,
/obj/random/medical/low_chance,
/obj/random/medical/low_chance,
/obj/random/medical/low_chance,
/obj/random/medical/low_chance,
/turf/simulated/floor/tiled/steel,
/area/deepmaint)
"ks" = (
/obj/structure/table/standard{
	name = "plastic table frame"
	},
/turf/simulated/floor/tiled/steel,
/area/deepmaint)
"lo" = (
/obj/effect/floor_decal/industrial/warning,
/turf/simulated/floor/tiled/steel,
/area/deepmaint)
"lU" = (
/obj/structure/table/standard{
	name = "plastic table frame"
	},
/obj/machinery/microscope,
/turf/simulated/floor/tiled/steel,
/area/deepmaint)
"mv" = (
/obj/structure/table/standard{
	name = "plastic table frame"
	},
/obj/item/pen,
/obj/item/paper_bin,
/turf/simulated/floor/tiled/steel,
/area/deepmaint)
"oW" = (
/turf/simulated/wall,
/area/deepmaint)
"pt" = (
/obj/effect/floor_decal/industrial/warning{
	dir = 8
	},
/obj/effect/damagedfloor/fire,
/turf/simulated/floor/tiled/steel,
/area/deepmaint)
"qD" = (
/obj/machinery/shower{
	dir = 4
	},
/obj/structure/catwalk,
/turf/simulated/floor/tiled/steel,
/area/deepmaint)
"rM" = (
/obj/effect/decal/cleanable/blood/splatter,
/turf/simulated/floor/tiled/steel,
/area/deepmaint)
"rO" = (
/obj/effect/decal/cleanable/blood/gibs,
/turf/simulated/floor/reinforced,
/area/deepmaint)
"rX" = (
/obj/effect/floor_decal/rust,
/obj/effect/damagedfloor/fire,
/turf/simulated/floor/reinforced,
/area/deepmaint)
"sk" = (
/obj/effect/floor_decal/industrial/warning,
/obj/machinery/light,
/obj/effect/decal/cleanable/blood/gibs,
/turf/simulated/floor/tiled/steel,
/area/deepmaint)
"sn" = (
/obj/effect/floor_decal/rust,
/turf/simulated/floor/reinforced,
/area/deepmaint)
"tP" = (
/obj/effect/floor_decal/industrial/warning{
	dir = 8
	},
/obj/structure/table/rack,
/obj/machinery/light{
	dir = 8
	},
/obj/random/medical/low_chance,
/obj/random/medical/low_chance,
/obj/random/medical/low_chance,
/obj/random/medical/low_chance,
/obj/random/medical/low_chance,
/obj/random/medical_lowcost/low_chance,
/obj/random/medical_lowcost/low_chance,
/obj/random/medical_lowcost/low_chance,
/obj/random/medical_lowcost/low_chance,
/obj/random/medical_lowcost/low_chance,
/obj/random/medical_lowcost/low_chance,
/turf/simulated/floor/tiled/steel,
/area/deepmaint)
"vn" = (
/mob/living/simple_animal/hostile/creature,
/turf/simulated/floor/reinforced,
/area/deepmaint)
"ww" = (
/obj/structure/table/standard{
	name = "plastic table frame"
	},
/obj/effect/decal/cleanable/reagents/splashed,
/turf/simulated/floor/tiled/steel,
/area/deepmaint)
"yy" = (
/obj/effect/decal/cleanable/mucus,
/obj/effect/damagedfloor/fire,
/turf/simulated/floor/reinforced,
/area/deepmaint)
"zl" = (
/obj/effect/floor_decal/industrial/warning{
	dir = 1
	},
/turf/simulated/floor/tiled/steel,
/area/deepmaint)
"Am" = (
/obj/structure/table/steel_reinforced,
/turf/simulated/floor/reinforced,
/area/deepmaint)
"BA" = (
/obj/effect/floor_decal/industrial/warning{
	dir = 1
	},
/obj/effect/damagedfloor/fire,
/turf/simulated/floor/tiled/steel,
/area/deepmaint)
"CX" = (
/obj/effect/window_lwall_spawn/smartspawn,
/turf/simulated/floor/tiled/steel,
/area/deepmaint)
"Do" = (
/obj/machinery/optable,
/obj/effect/decal/cleanable/blood/splatter,
/turf/simulated/floor/tiled/steel,
/area/deepmaint)
"IC" = (
/turf/simulated/floor/tiled/steel,
/area/deepmaint)
"IK" = (
/obj/effect/floor_decal/industrial/warning{
	dir = 8
	},
/obj/machinery/light{
	dir = 8
	},
/obj/effect/decal/cleanable/blood/gibs,
/turf/simulated/floor/tiled/steel,
/area/deepmaint)
"IZ" = (
/obj/structure/closet/l3closet/virology,
/turf/simulated/floor/tiled/steel,
/area/deepmaint)
"Jh" = (
/obj/structure/table/standard{
	name = "plastic table frame"
	},
/obj/item/storage/firstaid/surgery,
/turf/simulated/floor/tiled/steel,
/area/deepmaint)
"Jn" = (
/obj/structure/low_wall,
/obj/item/material/shard/plasma,
/obj/item/material/shard/plasma,
/obj/item/material/shard/plasma,
/obj/effect/damagedfloor/fire,
/turf/simulated/floor/tiled/steel,
/area/deepmaint)
"Kz" = (
/obj/effect/floor_decal/industrial/warning,
/obj/effect/floor_decal/industrial/warning{
	dir = 4
	},
/turf/simulated/floor/tiled/steel,
/area/deepmaint)
"LN" = (
/obj/effect/floor_decal/industrial/warning{
	dir = 4
	},
/obj/effect/floor_decal/industrial/warning{
	dir = 8
	},
/obj/effect/floor_decal/industrial/warning{
	dir = 1
	},
/obj/machinery/constructable_frame/machine_frame,
/turf/simulated/floor/tiled/steel,
/area/deepmaint)
"MA" = (
/obj/structure/table/standard{
	name = "plastic table frame"
	},
/obj/random/medical,
/turf/simulated/floor/tiled/steel,
/area/deepmaint)
"Ol" = (
/obj/effect/floor_decal/industrial/warning{
	dir = 8
	},
/obj/effect/floor_decal/industrial/warning,
/turf/simulated/floor/tiled/steel,
/area/deepmaint)
"OF" = (
/obj/effect/floor_decal/industrial/warning{
	dir = 1
	},
/obj/machinery/light{
	dir = 1
	},
/turf/simulated/floor/tiled/steel,
/area/deepmaint)
"Pd" = (
/obj/machinery/light,
/turf/simulated/floor/reinforced,
/area/deepmaint)
"Pp" = (
/obj/effect/decal/cleanable/mucus,
/obj/effect/floor_decal/rust,
/turf/simulated/floor/reinforced,
/area/deepmaint)
"PA" = (
/obj/structure/bed/chair/office/dark{
	dir = 4
	},
/obj/effect/decal/cleanable/blood/splatter,
/turf/simulated/floor/tiled/steel,
/area/deepmaint)
"Qk" = (
/obj/effect/floor_decal/industrial/warning{
	dir = 4
	},
/turf/simulated/floor/tiled/steel,
/area/deepmaint)
"Qy" = (
/obj/structure/bed/chair/office/dark,
/turf/simulated/floor/tiled/steel,
/area/deepmaint)
"Rl" = (
/obj/machinery/door/blast/regular/open,
/obj/structure/catwalk,
/turf/simulated/floor/reinforced,
/area/deepmaint)
"TU" = (
/obj/machinery/door/blast/regular,
/obj/structure/catwalk,
/turf/simulated/floor/reinforced,
/area/deepmaint)
"Ut" = (
/turf/simulated/floor/reinforced,
/area/deepmaint)
"UV" = (
/obj/effect/decal/cleanable/blood/gibs,
/turf/simulated/floor/tiled/steel,
/area/deepmaint)
"UY" = (
/obj/machinery/door/airlock/highsecurity,
/turf/simulated/floor/tiled/steel,
/area/deepmaint)
"Vb" = (
/obj/machinery/light{
	dir = 4;
	icon_state = "tube1"
	},
/turf/simulated/floor/reinforced,
/area/deepmaint)
"Vi" = (
/obj/effect/floor_decal/industrial/warning{
	dir = 8
	},
/obj/effect/floor_decal/industrial/warning{
	dir = 1
	},
/obj/effect/floor_decal/industrial/warning{
	dir = 4
	},
/obj/structure/closet/secure_closet/freezer,
/turf/simulated/floor/tiled/steel,
/area/deepmaint)
"Vp" = (
/obj/effect/window_lwall_spawn/plasma/reinforced,
/turf/simulated/floor/tiled/steel,
/area/deepmaint)
"Wy" = (
/turf/simulated/wall/r_wall,
/area/deepmaint)
"XQ" = (
/obj/effect/floor_decal/industrial/warning{
	dir = 1
	},
/obj/effect/decal/cleanable/blood/splatter,
/turf/simulated/floor/tiled/steel,
/area/deepmaint)
"YQ" = (
/obj/effect/floor_decal/industrial/warning{
	dir = 8
	},
/turf/simulated/floor/tiled/steel,
/area/deepmaint)

(1,1,1) = {"
IC
IC
IC
IC
IC
IC
IC
IC
IC
IC
IC
IC
IC
IC
IC
IC
IC
IC
IC
IC
IC
"}
(2,1,1) = {"
IC
IC
IC
IC
IC
IC
IC
IC
IC
IC
IC
IC
IC
IC
IC
IC
IC
IC
IC
IC
IC
"}
(3,1,1) = {"
IC
IC
Wy
Wy
Wy
Wy
Wy
Wy
Wy
Wy
Wy
Ut
Wy
Wy
Wy
Wy
Wy
Wy
Wy
IC
IC
"}
(4,1,1) = {"
IC
IC
Wy
Ut
gB
Ut
oW
Ut
gB
Ut
oW
rO
gB
Ut
oW
sn
Ut
Ut
Wy
IC
IC
"}
(5,1,1) = {"
IC
IC
Wy
Ut
Am
Ut
oW
Ut
Am
Ut
oW
Ut
Ut
Ut
oW
Ut
df
sn
Wy
IC
IC
"}
(6,1,1) = {"
IC
IC
Wy
Ut
Ut
Ut
oW
Ut
Ut
Ut
oW
Ut
rO
Ut
oW
df
sn
Pd
Wy
IC
IC
"}
(7,1,1) = {"
IC
IC
Wy
CX
TU
CX
oW
CX
TU
CX
oW
CX
Rl
CX
oW
Ut
sn
df
Wy
IC
IC
"}
(8,1,1) = {"
IC
IC
Wy
Vi
YQ
YQ
tP
YQ
YQ
pt
IK
YQ
YQ
Ol
Vp
yy
Ut
eF
Wy
IC
IC
"}
(9,1,1) = {"
IC
Wy
Wy
Wy
zl
ey
IC
rM
UV
UV
ey
UV
IC
ct
Jn
Pp
Ut
df
Wy
IC
IC
"}
(10,1,1) = {"
IC
Wy
qD
Wy
OF
IC
lU
ks
IC
ks
IC
Jh
rM
al
oW
df
Ut
Ut
Wy
IC
IC
"}
(11,1,1) = {"
IC
UY
IC
UY
XQ
UV
Qy
ey
IC
PA
ey
Do
IC
lo
TU
Ut
sn
Pd
Wy
IC
IC
"}
(12,1,1) = {"
IC
Wy
IZ
Wy
OF
ey
mv
ww
ey
ks
IC
MA
ey
sk
oW
Ut
Ut
Ut
Wy
IC
IC
"}
(13,1,1) = {"
IC
Wy
Wy
Wy
BA
IC
UV
IC
IC
UV
rM
IC
IC
lo
Vp
df
Ut
df
Wy
IC
IC
"}
(14,1,1) = {"
IC
IC
Wy
LN
Qk
Qk
cq
ei
Qk
Qk
it
Qk
Qk
Kz
Vp
df
rX
Ut
Wy
IC
IC
"}
(15,1,1) = {"
IC
IC
Wy
CX
TU
CX
oW
CX
Rl
CX
oW
CX
TU
CX
oW
Ut
Ut
df
Wy
IC
IC
"}
(16,1,1) = {"
IC
IC
Wy
Ut
Ut
Ut
oW
Ut
Ut
Ut
oW
Ut
Ut
Ut
oW
sn
Ut
Pd
Wy
IC
IC
"}
(17,1,1) = {"
IC
IC
Wy
Ut
Am
Ut
oW
Ut
vn
Ut
oW
Ut
Ut
Ut
oW
Ut
df
Ut
Wy
IC
IC
"}
(18,1,1) = {"
IC
IC
Wy
Ut
Vb
Ut
oW
Ut
Vb
Ut
oW
Ut
Vb
Ut
oW
Ut
Ut
sn
Wy
IC
IC
"}
(19,1,1) = {"
IC
IC
Wy
Wy
Wy
Wy
Wy
Wy
Wy
Wy
Wy
Wy
Wy
Wy
Wy
Wy
Wy
Wy
Wy
IC
IC
"}
(20,1,1) = {"
IC
IC
IC
IC
IC
IC
IC
IC
IC
IC
IC
IC
IC
IC
IC
IC
IC
IC
IC
IC
IC
"}
(21,1,1) = {"
IC
IC
IC
IC
IC
IC
IC
IC
IC
IC
IC
IC
IC
IC
IC
IC
IC
IC
IC
IC
IC
"}
