"aa" = (/obj/random/lowkeyrandom/low_chance,/turf/simulated/floor/tiled/steel,/area/deepmaint)
"ab" = (/obj/random/cluster/psi_monster/low_chance,/turf/simulated/floor/tiled/steel,/area/deepmaint)
"ac" = (/obj/machinery/light/small,/turf/simulated/floor/tiled/steel,/area/deepmaint)
"ad" = (/obj/structure/table/steel_reinforced,/obj/random/oddity_guns,/turf/simulated/floor/reinforced,/area/deepmaint)
"ae" = (/obj/effect/floor_decal/industrial/warning{dir = 1},/obj/random/pack/junk_machine/low_chance,/turf/simulated/floor/tiled/steel,/area/deepmaint)
"af" = (/obj/structure/closet/l3closet/virology,/obj/machinery/light/small{dir = 1},/turf/simulated/floor/tiled/steel,/area/deepmaint)
"ag" = (/obj/effect/floor_decal/industrial/warning{dir = 1},/obj/effect/damagedfloor/fire,/obj/random/pack/junk_machine/low_chance,/turf/simulated/floor/tiled/steel,/area/deepmaint)
"ah" = (/obj/machinery/light/small{dir = 4; pixel_y = 0},/turf/simulated/floor/tiled/steel,/area/deepmaint)
"ai" = (/obj/machinery/light/small{dir = 8},/turf/simulated/floor/tiled/steel,/area/deepmaint)
"aj" = (/obj/structure/table/standard{name = "plastic table frame"},/obj/random/powercell,/obj/random/powercell,/obj/random/powercell,/turf/simulated/floor/tiled/steel,/area/deepmaint)
"ak" = (/obj/structure/table/standard{name = "plastic table frame"},/obj/effect/decal/cleanable/reagents/splashed,/obj/random/material,/obj/random/material,/turf/simulated/floor/tiled/steel,/area/deepmaint)
"al" = (/obj/machinery/light/small{dir = 8},/turf/simulated/floor/reinforced,/area/deepmaint)
"am" = (/obj/effect/decal/cleanable/blood/gibs,/obj/effect/decal/cleanable/blood/gibs,/turf/simulated/floor/reinforced,/area/deepmaint)
"an" = (/obj/effect/decal/cleanable/blood/splatter,/obj/effect/decal/cleanable/blood/gibs,/obj/effect/decal/cleanable/blood/gibs,/obj/effect/decal/cleanable/blood/gibs,/obj/effect/decal/cleanable/blood/gibs,/turf/simulated/floor/reinforced,/area/deepmaint)
"ao" = (/obj/effect/decal/cleanable/blood/splatter,/obj/effect/decal/cleanable/blood/gibs,/turf/simulated/floor/reinforced,/area/deepmaint)
"ap" = (/obj/random/pack/junk_machine,/turf/simulated/floor/tiled/steel,/area/deepmaint)
"aq" = (/obj/random/cluster/psi_monster,/turf/simulated/floor/tiled/steel,/area/deepmaint)
"ar" = (/obj/effect/damagedfloor/fire,/obj/random/pack/junk_machine,/turf/simulated/floor/tiled/steel,/area/deepmaint)
"as" = (/obj/effect/decal/cleanable/blood/splatter,/obj/effect/decal/cleanable/blood/gibs,/obj/effect/decal/cleanable/blood/gibs,/turf/simulated/floor/reinforced,/area/deepmaint)
"at" = (/obj/effect/decal/cleanable/blood/splatter,/obj/effect/decal/cleanable/blood/splatter,/obj/effect/decal/cleanable/blood/gibs,/obj/effect/decal/cleanable/blood/gibs,/turf/simulated/floor/reinforced,/area/deepmaint)
"au" = (/obj/machinery/light/small{dir = 4},/turf/simulated/floor/reinforced,/area/deepmaint)
"av" = (/obj/structure/table/standard{name = "plastic table frame"},/obj/item/tool/omnitool,/turf/simulated/floor/tiled/steel,/area/deepmaint)
"aw" = (/obj/effect/decal/cleanable/blood/splatter,/obj/effect/decal/cleanable/blood/splatter,/obj/effect/decal/cleanable/blood/gibs,/obj/effect/decal/cleanable/blood/gibs,/obj/effect/decal/cleanable/blood/gibs,/turf/simulated/floor/reinforced,/area/deepmaint)
"ax" = (/obj/item/material/shard/shrapnel/scrap,/obj/item/material/shard/shrapnel/scrap,/obj/item/material/shard/shrapnel/scrap,/turf/simulated/floor/reinforced,/area/deepmaint)
"ay" = (/obj/random/scrap/dense_weighted,/turf/simulated/floor/reinforced,/area/deepmaint)
"az" = (/obj/item/material/shard/shrapnel/scrap,/turf/simulated/floor/tiled/steel,/area/deepmaint)
"aA" = (/obj/item/material/shard/shrapnel/scrap,/turf/simulated/floor/reinforced,/area/deepmaint)
"aB" = (/obj/structure/table/standard{name = "plastic table frame"},/obj/item/pen,/obj/item/paper_bin,/obj/item/oddity/common/healthscanner,/turf/simulated/floor/tiled/steel,/area/deepmaint)
"aC" = (/obj/random/cluster/psi_monster/low_chance,/obj/machinery/light/small{dir = 4; pixel_y = 0},/turf/simulated/floor/tiled/steel,/area/deepmaint)
"aD" = (/obj/effect/decal/cleanable/blood/gibs,/obj/machinery/light/small{dir = 4},/turf/simulated/floor/reinforced,/area/deepmaint)
"aE" = (/obj/effect/decal/cleanable/dirt,/obj/effect/decal/cleanable/dirt,/turf/simulated/floor/tiled/white/brown_perforated,/area/deepmaint)
"aF" = (/obj/effect/decal/cleanable/dirt,/turf/simulated/floor/reinforced,/area/deepmaint)
"aG" = (/obj/effect/decal/cleanable/dirt,/obj/effect/decal/cleanable/dirt,/turf/simulated/floor/reinforced,/area/deepmaint)
"aH" = (/obj/random/scrap/dense_weighted,/obj/machinery/light/small{dir = 4},/turf/simulated/floor/reinforced,/area/deepmaint)
"aI" = (/turf/simulated/floor/tiled/white/brown_perforated,/area/deepmaint)
"aJ" = (/obj/effect/floor_decal/industrial/warning,/obj/effect/decal/cleanable/blood/gibs,/turf/simulated/floor/tiled/steel,/area/deepmaint)
"aK" = (/obj/random/cluster/psi_monster,/turf/simulated/floor/reinforced,/area/deepmaint)
"aL" = (/obj/structure/table/standard,/obj/machinery/chem_heater,/turf/simulated/floor/tiled/steel/techfloor,/area/deepmaint)
"aM" = (/obj/effect/decal/cleanable/dirt,/obj/structure/bed/chair/office/light,/obj/machinery/light,/turf/simulated/floor/tiled/white/brown_perforated,/area/deepmaint)
"aN" = (/obj/structure/closet/secure_closet/freezer/blood,/turf/simulated/floor/tiled/steel/techfloor,/area/deepmaint)
"aO" = (/obj/structure/table/glass,/obj/random/medical,/obj/random/medical,/obj/random/medical/low_chance,/obj/random/medical/low_chance,/obj/random/medical/low_chance,/obj/random/medical/low_chance,/turf/simulated/floor/tiled/steel/techfloor,/area/deepmaint)
"aP" = (/obj/structure/table/glass,/obj/item/storage/freezer/medical,/obj/item/cell/medium/high,/turf/simulated/floor/tiled/steel/techfloor,/area/deepmaint)
"aQ" = (/obj/machinery/chem_master,/turf/simulated/floor/tiled/steel/techfloor,/area/deepmaint)
"aR" = (/obj/machinery/light/small{dir = 1},/turf/simulated/floor/tiled/steel,/area/deepmaint)
"aS" = (/obj/random/cluster/psi_monster/low_chance,/obj/machinery/light/small{dir = 1},/turf/simulated/floor/tiled/steel,/area/deepmaint)
"aT" = (/obj/structure/table/standard{name = "plastic table frame"},/obj/random/psi_megafauna,/turf/simulated/floor/tiled/steel,/area/deepmaint)
"aU" = (/obj/structure/table/standard,/obj/item/reagent_containers/dropper{pixel_y = -4},/obj/item/storage/box/syringes{pixel_x = 3; pixel_y = 3},/obj/item/storage/box/beakers,/obj/item/reagent_containers/glass/beaker/large,/turf/simulated/floor/tiled/steel/techfloor,/area/deepmaint)
"aV" = (/obj/effect/decal/cleanable/blood,/turf/simulated/floor/reinforced,/area/deepmaint)
"aW" = (/obj/effect/floor_decal/rust,/obj/effect/decal/cleanable/blood/gibs,/turf/simulated/floor/reinforced,/area/deepmaint)
"aX" = (/obj/effect/decal/cleanable/blood/gibs,/turf/simulated/floor/tiled/steel/brown_perforated,/area/deepmaint)
"aY" = (/obj/effect/decal/cleanable/blood,/turf/simulated/floor/tiled/steel/brown_perforated,/area/deepmaint)
"aZ" = (/obj/structure/table/glass,/obj/item/storage/firstaid/surgery,/turf/simulated/floor/tiled/steel/techfloor,/area/deepmaint)
"ba" = (/obj/machinery/chemical_dispenser,/obj/effect/floor_decal/steeldecal/steel_decals10{dir = 5},/turf/simulated/floor/tiled/steel/techfloor,/area/deepmaint)
"bb" = (/obj/structure/table/standard,/obj/item/reagent_containers/dropper{pixel_y = -4},/obj/item/storage/box/syringes{pixel_x = 3; pixel_y = 3},/obj/item/storage/box/beakers,/obj/item/reagent_containers/glass/beaker/large,/obj/item/tool/screwdriver,/turf/simulated/floor/tiled/steel/techfloor,/area/deepmaint)
"bc" = (/obj/structure/table/standard,/obj/machinery/centrifuge,/turf/simulated/floor/tiled/steel/techfloor,/area/deepmaint)
"bd" = (/obj/structure/table/standard,/obj/machinery/electrolyzer,/turf/simulated/floor/tiled/steel/techfloor,/area/deepmaint)
"be" = (/obj/machinery/gibber/autogibber,/turf/simulated/floor/tiled/steel/techfloor,/area/deepmaint)
"bf" = (/obj/machinery/light_construct,/obj/structure/kitchenspike,/obj/effect/decal/cleanable/blood,/obj/effect/decal/cleanable/blood/gibs,/turf/simulated/floor/tiled/steel/techfloor,/area/deepmaint)
"bg" = (/obj/structure/table/standard{name = "plastic table frame"},/obj/item/oddity/common/old_knife,/turf/simulated/floor/tiled/steel/techfloor,/area/deepmaint)
"bh" = (/obj/effect/decal/cleanable/blood/gibs,/turf/simulated/floor/tiled/steel/techfloor,/area/deepmaint)
"bi" = (/obj/machinery/optable,/obj/effect/decal/cleanable/blood,/turf/simulated/floor/tiled/steel/techfloor,/area/deepmaint)
"bj" = (/obj/structure/medical_stand,/turf/simulated/floor/tiled/steel/techfloor,/area/deepmaint)
"bk" = (/obj/effect/window_lwall_spawn/smartspawn,/turf/simulated/floor/tiled/white/brown_perforated,/area/deepmaint)
"bl" = (/obj/effect/window_lwall_spawn/plasma/reinforced,/turf/simulated/floor/tiled/white/brown_perforated,/area/deepmaint)
"bm" = (/obj/structure/low_wall,/obj/item/material/shard/plasma,/obj/item/material/shard/plasma,/obj/item/material/shard/plasma,/obj/effect/damagedfloor/fire,/turf/simulated/floor/tiled/white/brown_perforated,/area/deepmaint)
"cq" = (/obj/effect/floor_decal/industrial/warning{dir = 4},/obj/machinery/light{dir = 4; icon_state = "tube1"},/obj/machinery/smartfridge,/turf/simulated/floor/tiled/steel,/area/deepmaint)
"ct" = (/obj/effect/floor_decal/industrial/warning,/obj/effect/decal/cleanable/blood/gibs,/obj/effect/damagedfloor/fire,/turf/simulated/floor/tiled/steel,/area/deepmaint)
"df" = (/obj/effect/damagedfloor/fire,/turf/simulated/floor/reinforced,/area/deepmaint)
"ei" = (/obj/effect/floor_decal/industrial/warning{dir = 4},/obj/effect/damagedfloor/fire,/turf/simulated/floor/tiled/steel,/area/deepmaint)
"ey" = (/obj/effect/damagedfloor/fire,/turf/simulated/floor/tiled/steel,/area/deepmaint)
"it" = (/obj/effect/floor_decal/industrial/warning{dir = 4},/obj/structure/table/rack,/obj/machinery/light{dir = 4; icon_state = "tube1"},/obj/random/medical_lowcost/low_chance,/obj/random/medical_lowcost/low_chance,/obj/random/medical_lowcost/low_chance,/obj/random/medical_lowcost/low_chance,/obj/random/medical_lowcost/low_chance,/obj/random/medical_lowcost/low_chance,/obj/random/medical/low_chance,/obj/random/medical/low_chance,/obj/random/medical/low_chance,/obj/random/medical/low_chance,/obj/random/medical/low_chance,/turf/simulated/floor/tiled/steel,/area/deepmaint)
"lo" = (/obj/effect/floor_decal/industrial/warning,/turf/simulated/floor/tiled/steel,/area/deepmaint)
"lU" = (/obj/structure/table/standard{name = "plastic table frame"},/obj/machinery/microscope,/turf/simulated/floor/tiled/steel,/area/deepmaint)
"oW" = (/turf/simulated/wall,/area/deepmaint)
"pt" = (/obj/effect/floor_decal/industrial/warning{dir = 8},/obj/effect/damagedfloor/fire,/turf/simulated/floor/tiled/steel,/area/deepmaint)
"qD" = (/obj/machinery/shower{dir = 4},/obj/structure/catwalk,/turf/simulated/floor/tiled/steel,/area/deepmaint)
"rM" = (/obj/effect/decal/cleanable/blood/splatter,/turf/simulated/floor/tiled/steel,/area/deepmaint)
"rO" = (/obj/effect/decal/cleanable/blood/gibs,/turf/simulated/floor/reinforced,/area/deepmaint)
"rX" = (/obj/effect/floor_decal/rust,/obj/effect/damagedfloor/fire,/turf/simulated/floor/reinforced,/area/deepmaint)
"tP" = (/obj/effect/floor_decal/industrial/warning{dir = 8},/obj/structure/table/rack,/obj/machinery/light{dir = 8},/obj/random/medical/low_chance,/obj/random/medical/low_chance,/obj/random/medical/low_chance,/obj/random/medical/low_chance,/obj/random/medical/low_chance,/obj/random/medical_lowcost/low_chance,/obj/random/medical_lowcost/low_chance,/obj/random/medical_lowcost/low_chance,/obj/random/medical_lowcost/low_chance,/obj/random/medical_lowcost/low_chance,/obj/random/medical_lowcost/low_chance,/turf/simulated/floor/tiled/steel,/area/deepmaint)
"yy" = (/obj/effect/decal/cleanable/mucus,/obj/effect/damagedfloor/fire,/turf/simulated/floor/reinforced,/area/deepmaint)
"Do" = (/obj/machinery/optable,/obj/effect/decal/cleanable/blood/splatter,/turf/simulated/floor/tiled/steel,/area/deepmaint)
"IC" = (/turf/simulated/floor/tiled/steel,/area/deepmaint)
"IK" = (/obj/effect/floor_decal/industrial/warning{dir = 8},/obj/machinery/light{dir = 8},/obj/effect/decal/cleanable/blood/gibs,/turf/simulated/floor/tiled/steel,/area/deepmaint)
"Jh" = (/obj/structure/table/standard{name = "plastic table frame"},/obj/item/storage/firstaid/surgery,/turf/simulated/floor/tiled/steel,/area/deepmaint)
"Kz" = (/obj/effect/floor_decal/industrial/warning,/obj/effect/floor_decal/industrial/warning{dir = 4},/turf/simulated/floor/tiled/steel,/area/deepmaint)
"LN" = (/obj/effect/floor_decal/industrial/warning{dir = 4},/obj/effect/floor_decal/industrial/warning{dir = 8},/obj/effect/floor_decal/industrial/warning{dir = 1},/obj/machinery/constructable_frame/machine_frame,/turf/simulated/floor/tiled/steel,/area/deepmaint)
"MA" = (/obj/structure/table/standard{name = "plastic table frame"},/obj/random/medical,/turf/simulated/floor/tiled/steel,/area/deepmaint)
"Ol" = (/obj/effect/floor_decal/industrial/warning{dir = 8},/obj/effect/floor_decal/industrial/warning,/turf/simulated/floor/tiled/steel,/area/deepmaint)
"Pp" = (/obj/effect/decal/cleanable/mucus,/obj/effect/floor_decal/rust,/turf/simulated/floor/reinforced,/area/deepmaint)
"PA" = (/obj/structure/bed/chair/office/dark{dir = 4},/obj/effect/decal/cleanable/blood/splatter,/turf/simulated/floor/tiled/steel,/area/deepmaint)
"Qk" = (/obj/effect/floor_decal/industrial/warning{dir = 4},/turf/simulated/floor/tiled/steel,/area/deepmaint)
"Qy" = (/obj/structure/bed/chair/office/dark,/turf/simulated/floor/tiled/steel,/area/deepmaint)
"Rl" = (/obj/machinery/door/blast/regular/open,/obj/structure/catwalk,/turf/simulated/floor/reinforced,/area/deepmaint)
"TU" = (/obj/machinery/door/blast/regular,/obj/structure/catwalk,/turf/simulated/floor/reinforced,/area/deepmaint)
"Ut" = (/turf/simulated/floor/reinforced,/area/deepmaint)
"UV" = (/obj/effect/decal/cleanable/blood/gibs,/turf/simulated/floor/tiled/steel,/area/deepmaint)
"UY" = (/obj/machinery/door/airlock/highsecurity,/turf/simulated/floor/tiled/steel,/area/deepmaint)
"Vi" = (/obj/effect/floor_decal/industrial/warning{dir = 8},/obj/effect/floor_decal/industrial/warning{dir = 1},/obj/effect/floor_decal/industrial/warning{dir = 4},/obj/structure/closet/secure_closet/freezer,/turf/simulated/floor/tiled/steel,/area/deepmaint)
"Wy" = (/turf/simulated/wall/r_wall,/area/deepmaint)
"XQ" = (/obj/effect/floor_decal/industrial/warning{dir = 1},/obj/effect/decal/cleanable/blood/splatter,/turf/simulated/floor/tiled/steel,/area/deepmaint)
"YQ" = (/obj/effect/floor_decal/industrial/warning{dir = 8},/turf/simulated/floor/tiled/steel,/area/deepmaint)

(1,1,1) = {"
ICICICICICICaaICICICICICaaaaaaaaICICICICIC
ICaaICICabacICICWyWyUYWyWyICICacICICICaaIC
ICaaWyWyWyWyWyWyWyqDICafWyWyWyWyWyWyWyICIC
aaaaWyUtUtUtbkViWyWyUYWyWyLNbkUtUtUtWyICaa
ICICWyaladUtTUYQaeaeXQaeagQkTUUtadauWyICaa
ICICWyUtUtUtbkYQeyICUVeyICQkbkUtUtUtWyICIC
ICahWyoWoWoWoWtPIClUQyaBUVcqoWoWoWoWWyaiab
ICICWyUtUtUtbkYQrMajeyakICeibkamanaoWyICIC
ICICWyaladUtTUYQUVapaqarICQkRlasataDWyICaa
ICaaWyUtUtUtbkptUVaTPAavUVQkbkUtawaoWyICaa
ICaaWyoWoWoWoWIKeyICeyICrMitoWoWoWoWWyICIC
ICICaxrOUtUtbkYQUVJhDoMAICQkbkayayayWyICIC
azICWyalaArORlYQICrMICeyICQkTUUtayaHWyICIC
aaICWyUtUtUtbkOlctloloaJloKzbkayayayWyICaa
aaICWyWyWyWyWyblbmoWTUoWblbloWoWoWoWWyICaa
ICaCWyaLaEaFaGyyPpdfUtUtdfdfUtaNaOaPWyaiaa
ICICWyaQaIaUUtUtUtaVaWUtUtrXaKaXaYaZWyaaIC
ICICWybaaMbbbcbdUtbebfbgdfUtdfbhbibjWyICIC
aaICWyWyWyWyWyWyWyWyWyWyWyWyWyWyWyWyWyICIC
aaICICICICaRICICICICICICICICICaSICICICICIC
aaICICICICICICaaICICICaaaaaaICICICaaaaaaIC
"}
