//MAP CONVERTED BY dmm2tgm.py THIS HEADER COMMENT PREVENTS RECONVERSION, DO NOT REMOVE
"as" = (
/obj/item/material/shard/shrapnel/scrap,
/turf/simulated/floor/tiled/steel,
/area/deepmaint)
"ax" = (
/obj/effect/decal/cleanable/dirt,
/obj/effect/decal/cleanable/dirt,
/turf/simulated/floor/tiled/white/brown_perforated,
/area/deepmaint)
"cq" = (
/obj/effect/floor_decal/industrial/warning{
	dir = 4
	},
/obj/machinery/light{
	dir = 4;
	icon_state = "tube1"
	},
/obj/machinery/smartfridge,
/turf/simulated/floor/tiled/steel,
/area/deepmaint)
"ct" = (
/obj/effect/floor_decal/industrial/warning,
/obj/effect/decal/cleanable/blood/gibs,
/obj/effect/damagedfloor/fire,
/turf/simulated/floor/tiled/steel,
/area/deepmaint)
"db" = (
/obj/structure/table/glass,
/obj/random/medical,
/obj/random/medical,
/obj/random/medical/low_chance,
/obj/random/medical/low_chance,
/obj/random/medical/low_chance,
/obj/random/medical/low_chance,
/turf/simulated/floor/tiled/steel/techfloor,
/area/deepmaint)
"df" = (
/obj/effect/damagedfloor/fire,
/turf/simulated/floor/reinforced,
/area/deepmaint)
"dq" = (
/obj/machinery/light/small{
	dir = 8
	},
/turf/simulated/floor/tiled/steel,
/area/deepmaint)
"ei" = (
/obj/effect/floor_decal/industrial/warning{
	dir = 4
	},
/obj/effect/damagedfloor/fire,
/turf/simulated/floor/tiled/steel,
/area/deepmaint)
"er" = (
/obj/machinery/chem_master,
/turf/simulated/floor/tiled/steel/techfloor,
/area/deepmaint)
"ey" = (
/obj/effect/damagedfloor/fire,
/turf/simulated/floor/tiled/steel,
/area/deepmaint)
"eD" = (
/turf/simulated/floor/tiled/white/brown_perforated,
/area/deepmaint)
"eF" = (
/obj/structure/table/standard,
/obj/machinery/electrolyzer,
/turf/simulated/floor/tiled/steel/techfloor,
/area/deepmaint)
"fj" = (
/obj/effect/decal/cleanable/blood,
/turf/simulated/floor/tiled/steel/brown_perforated,
/area/deepmaint)
"fZ" = (
/obj/structure/table/standard,
/obj/machinery/centrifuge,
/turf/simulated/floor/tiled/steel/techfloor,
/area/deepmaint)
"gx" = (
/obj/random/pack/junk_machine,
/turf/simulated/floor/tiled/steel,
/area/deepmaint)
"gB" = (
/obj/machinery/light/small{
	dir = 8
	},
/turf/simulated/floor/reinforced,
/area/deepmaint)
"hP" = (
/obj/structure/table/standard{
	name = "plastic table frame"
	},
/obj/item/oddity/common/old_knife,
/turf/simulated/floor/tiled/steel/techfloor,
/area/deepmaint)
"it" = (
/obj/effect/floor_decal/industrial/warning{
	dir = 4
	},
/obj/structure/table/rack,
/obj/machinery/light{
	dir = 4;
	icon_state = "tube1"
	},
/obj/random/medical_lowcost/low_chance,
/obj/random/medical_lowcost/low_chance,
/obj/random/medical_lowcost/low_chance,
/obj/random/medical_lowcost/low_chance,
/obj/random/medical_lowcost/low_chance,
/obj/random/medical_lowcost/low_chance,
/obj/random/medical/low_chance,
/obj/random/medical/low_chance,
/obj/random/medical/low_chance,
/obj/random/medical/low_chance,
/obj/random/medical/low_chance,
/turf/simulated/floor/tiled/steel,
/area/deepmaint)
"iF" = (
/obj/effect/decal/cleanable/blood/splatter,
/obj/effect/decal/cleanable/blood/gibs,
/obj/effect/decal/cleanable/blood/gibs,
/obj/effect/decal/cleanable/blood/gibs,
/obj/effect/decal/cleanable/blood/gibs,
/turf/simulated/floor/reinforced,
/area/deepmaint)
"iY" = (
/obj/structure/table/standard{
	name = "plastic table frame"
	},
/obj/random/psi_megafauna,
/turf/simulated/floor/tiled/steel,
/area/deepmaint)
"jd" = (
/obj/random/cluster/psi_monster,
/turf/simulated/floor/tiled/steel,
/area/deepmaint)
"jI" = (
/obj/structure/table/standard,
/obj/item/reagent_containers/dropper{
	pixel_y = -4
	},
/obj/item/storage/box/syringes{
	pixel_x = 3;
	pixel_y = 3
	},
/obj/item/storage/box/beakers,
/obj/item/reagent_containers/glass/beaker/large,
/turf/simulated/floor/tiled/steel/techfloor,
/area/deepmaint)
"jL" = (
/obj/machinery/light_construct,
/obj/structure/kitchenspike,
/obj/effect/decal/cleanable/blood,
/obj/effect/decal/cleanable/blood/gibs,
/turf/simulated/floor/tiled/steel/techfloor,
/area/deepmaint)
"ka" = (
/obj/structure/table/glass,
/obj/item/storage/freezer/medical,
/obj/item/cell/medium/high,
/turf/simulated/floor/tiled/steel/techfloor,
/area/deepmaint)
"ks" = (
/obj/structure/table/standard{
	name = "plastic table frame"
	},
/obj/random/powercell,
/obj/random/powercell,
/obj/random/powercell,
/turf/simulated/floor/tiled/steel,
/area/deepmaint)
"lo" = (
/obj/effect/floor_decal/industrial/warning,
/turf/simulated/floor/tiled/steel,
/area/deepmaint)
"lK" = (
/obj/machinery/light/small,
/turf/simulated/floor/tiled/steel,
/area/deepmaint)
"lU" = (
/obj/structure/table/standard{
	name = "plastic table frame"
	},
/obj/machinery/microscope,
/turf/simulated/floor/tiled/steel,
/area/deepmaint)
"mv" = (
/obj/structure/table/standard{
	name = "plastic table frame"
	},
/obj/item/pen,
/obj/item/paper_bin,
/obj/item/oddity/common/healthscanner,
/turf/simulated/floor/tiled/steel,
/area/deepmaint)
"mF" = (
/obj/effect/decal/cleanable/dirt,
/turf/simulated/floor/reinforced,
/area/deepmaint)
"na" = (
/obj/structure/table/glass,
/obj/item/storage/firstaid/surgery,
/turf/simulated/floor/tiled/steel/techfloor,
/area/deepmaint)
"nw" = (
/obj/random/cluster/psi_monster/low_chance,
/turf/simulated/floor/tiled/steel,
/area/deepmaint)
"nC" = (
/obj/random/lowkeyrandom/low_chance,
/turf/simulated/floor/tiled/steel,
/area/deepmaint)
"oc" = (
/obj/machinery/light/small{
	dir = 4;
	pixel_y = 0
	},
/turf/simulated/floor/tiled/steel,
/area/deepmaint)
"oW" = (
/turf/simulated/wall,
/area/deepmaint)
"pt" = (
/obj/effect/floor_decal/industrial/warning{
	dir = 8
	},
/obj/effect/damagedfloor/fire,
/turf/simulated/floor/tiled/steel,
/area/deepmaint)
"qD" = (
/obj/machinery/shower{
	dir = 4
	},
/obj/structure/catwalk,
/turf/simulated/floor/tiled/steel,
/area/deepmaint)
"rc" = (
/obj/random/scrap/dense_weighted,
/obj/machinery/light/small{
	dir = 4
	},
/turf/simulated/floor/reinforced,
/area/deepmaint)
"rp" = (
/obj/effect/decal/cleanable/blood/splatter,
/obj/effect/decal/cleanable/blood/splatter,
/obj/effect/decal/cleanable/blood/gibs,
/obj/effect/decal/cleanable/blood/gibs,
/obj/effect/decal/cleanable/blood/gibs,
/turf/simulated/floor/reinforced,
/area/deepmaint)
"rH" = (
/obj/effect/decal/cleanable/blood/splatter,
/obj/effect/decal/cleanable/blood/gibs,
/obj/effect/decal/cleanable/blood/gibs,
/turf/simulated/floor/reinforced,
/area/deepmaint)
"rM" = (
/obj/effect/decal/cleanable/blood/splatter,
/turf/simulated/floor/tiled/steel,
/area/deepmaint)
"rO" = (
/obj/effect/decal/cleanable/blood/gibs,
/turf/simulated/floor/reinforced,
/area/deepmaint)
"rX" = (
/obj/effect/floor_decal/rust,
/obj/effect/damagedfloor/fire,
/turf/simulated/floor/reinforced,
/area/deepmaint)
"sk" = (
/obj/effect/floor_decal/industrial/warning,
/obj/effect/decal/cleanable/blood/gibs,
/turf/simulated/floor/tiled/steel,
/area/deepmaint)
"sn" = (
/obj/structure/table/standard,
/obj/machinery/chem_heater,
/turf/simulated/floor/tiled/steel/techfloor,
/area/deepmaint)
"sp" = (
/obj/effect/decal/cleanable/blood,
/turf/simulated/floor/reinforced,
/area/deepmaint)
"tP" = (
/obj/effect/floor_decal/industrial/warning{
	dir = 8
	},
/obj/structure/table/rack,
/obj/machinery/light{
	dir = 8
	},
/obj/random/medical/low_chance,
/obj/random/medical/low_chance,
/obj/random/medical/low_chance,
/obj/random/medical/low_chance,
/obj/random/medical/low_chance,
/obj/random/medical_lowcost/low_chance,
/obj/random/medical_lowcost/low_chance,
/obj/random/medical_lowcost/low_chance,
/obj/random/medical_lowcost/low_chance,
/obj/random/medical_lowcost/low_chance,
/obj/random/medical_lowcost/low_chance,
/turf/simulated/floor/tiled/steel,
/area/deepmaint)
"tZ" = (
/obj/item/material/shard/shrapnel/scrap,
/turf/simulated/floor/reinforced,
/area/deepmaint)
"uV" = (
/obj/effect/decal/cleanable/blood/gibs,
/turf/simulated/floor/tiled/steel/techfloor,
/area/deepmaint)
"vn" = (
/obj/effect/decal/cleanable/blood/splatter,
/obj/effect/decal/cleanable/blood/splatter,
/obj/effect/decal/cleanable/blood/gibs,
/obj/effect/decal/cleanable/blood/gibs,
/turf/simulated/floor/reinforced,
/area/deepmaint)
"ww" = (
/obj/structure/table/standard{
	name = "plastic table frame"
	},
/obj/effect/decal/cleanable/reagents/splashed,
/obj/random/material,
/obj/random/material,
/turf/simulated/floor/tiled/steel,
/area/deepmaint)
"xT" = (
/obj/random/cluster/psi_monster/low_chance,
/obj/machinery/light/small{
	dir = 1
	},
/turf/simulated/floor/tiled/steel,
/area/deepmaint)
"yy" = (
/obj/effect/decal/cleanable/mucus,
/obj/effect/damagedfloor/fire,
/turf/simulated/floor/reinforced,
/area/deepmaint)
"yW" = (
/obj/structure/medical_stand,
/turf/simulated/floor/tiled/steel/techfloor,
/area/deepmaint)
"zd" = (
/obj/effect/damagedfloor/fire,
/obj/random/pack/junk_machine,
/turf/simulated/floor/tiled/steel,
/area/deepmaint)
"ze" = (
/obj/machinery/chemical_dispenser,
/obj/effect/floor_decal/steeldecal/steel_decals10{
	dir = 5
	},
/turf/simulated/floor/tiled/steel/techfloor,
/area/deepmaint)
"zl" = (
/obj/effect/floor_decal/industrial/warning{
	dir = 1
	},
/obj/random/pack/junk_machine/low_chance,
/turf/simulated/floor/tiled/steel,
/area/deepmaint)
"Am" = (
/obj/structure/table/steel_reinforced,
/obj/random/oddity_guns,
/turf/simulated/floor/reinforced,
/area/deepmaint)
"Bb" = (
/obj/effect/decal/cleanable/blood/gibs,
/turf/simulated/floor/tiled/steel/brown_perforated,
/area/deepmaint)
"Bz" = (
/obj/random/cluster/psi_monster,
/turf/simulated/floor/reinforced,
/area/deepmaint)
"BA" = (
/obj/effect/floor_decal/industrial/warning{
	dir = 1
	},
/obj/effect/damagedfloor/fire,
/obj/random/pack/junk_machine/low_chance,
/turf/simulated/floor/tiled/steel,
/area/deepmaint)
"BK" = (
/obj/machinery/optable,
/obj/effect/decal/cleanable/blood,
/turf/simulated/floor/tiled/steel/techfloor,
/area/deepmaint)
"CX" = (
/obj/effect/window_lwall_spawn/smartspawn,
/turf/simulated/floor/tiled/white/brown_perforated,
/area/deepmaint)
"Do" = (
/obj/machinery/optable,
/obj/effect/decal/cleanable/blood/splatter,
/turf/simulated/floor/tiled/steel,
/area/deepmaint)
"FA" = (
/obj/effect/decal/cleanable/blood/gibs,
/obj/effect/decal/cleanable/blood/gibs,
/turf/simulated/floor/reinforced,
/area/deepmaint)
"IC" = (
/turf/simulated/floor/tiled/steel,
/area/deepmaint)
"IK" = (
/obj/effect/floor_decal/industrial/warning{
	dir = 8
	},
/obj/machinery/light{
	dir = 8
	},
/obj/effect/decal/cleanable/blood/gibs,
/turf/simulated/floor/tiled/steel,
/area/deepmaint)
"IS" = (
/obj/effect/decal/cleanable/dirt,
/obj/structure/bed/chair/office/light,
/obj/machinery/light,
/turf/simulated/floor/tiled/white/brown_perforated,
/area/deepmaint)
"IZ" = (
/obj/structure/closet/l3closet/virology,
/obj/machinery/light/small{
	dir = 1
	},
/turf/simulated/floor/tiled/steel,
/area/deepmaint)
"Jh" = (
/obj/structure/table/standard{
	name = "plastic table frame"
	},
/obj/item/storage/firstaid/surgery,
/turf/simulated/floor/tiled/steel,
/area/deepmaint)
"Jn" = (
/obj/structure/low_wall,
/obj/item/material/shard/plasma,
/obj/item/material/shard/plasma,
/obj/item/material/shard/plasma,
/obj/effect/damagedfloor/fire,
/turf/simulated/floor/tiled/white/brown_perforated,
/area/deepmaint)
"Kx" = (
/obj/effect/decal/cleanable/blood/splatter,
/obj/effect/decal/cleanable/blood/gibs,
/turf/simulated/floor/reinforced,
/area/deepmaint)
"Kz" = (
/obj/effect/floor_decal/industrial/warning,
/obj/effect/floor_decal/industrial/warning{
	dir = 4
	},
/turf/simulated/floor/tiled/steel,
/area/deepmaint)
"Lf" = (
/obj/machinery/light/small{
	dir = 1
	},
/turf/simulated/floor/tiled/steel,
/area/deepmaint)
"LN" = (
/obj/effect/floor_decal/industrial/warning{
	dir = 4
	},
/obj/effect/floor_decal/industrial/warning{
	dir = 8
	},
/obj/effect/floor_decal/industrial/warning{
	dir = 1
	},
/obj/machinery/constructable_frame/machine_frame,
/turf/simulated/floor/tiled/steel,
/area/deepmaint)
"My" = (
/obj/effect/decal/cleanable/dirt,
/obj/effect/decal/cleanable/dirt,
/turf/simulated/floor/reinforced,
/area/deepmaint)
"MA" = (
/obj/structure/table/standard{
	name = "plastic table frame"
	},
/obj/random/medical,
/turf/simulated/floor/tiled/steel,
/area/deepmaint)
"Ol" = (
/obj/effect/floor_decal/industrial/warning{
	dir = 8
	},
/obj/effect/floor_decal/industrial/warning,
/turf/simulated/floor/tiled/steel,
/area/deepmaint)
"Oo" = (
/obj/structure/table/standard{
	name = "plastic table frame"
	},
/obj/item/tool/omnitool,
/turf/simulated/floor/tiled/steel,
/area/deepmaint)
"Pd" = (
/obj/structure/table/standard,
/obj/item/reagent_containers/dropper{
	pixel_y = -4
	},
/obj/item/storage/box/syringes{
	pixel_x = 3;
	pixel_y = 3
	},
/obj/item/storage/box/beakers,
/obj/item/reagent_containers/glass/beaker/large,
/obj/item/tool/screwdriver,
/turf/simulated/floor/tiled/steel/techfloor,
/area/deepmaint)
"Pp" = (
/obj/effect/decal/cleanable/mucus,
/obj/effect/floor_decal/rust,
/turf/simulated/floor/reinforced,
/area/deepmaint)
"PA" = (
/obj/structure/bed/chair/office/dark{
	dir = 4
	},
/obj/effect/decal/cleanable/blood/splatter,
/turf/simulated/floor/tiled/steel,
/area/deepmaint)
"Qe" = (
/obj/effect/floor_decal/rust,
/obj/effect/decal/cleanable/blood/gibs,
/turf/simulated/floor/reinforced,
/area/deepmaint)
"Qk" = (
/obj/effect/floor_decal/industrial/warning{
	dir = 4
	},
/turf/simulated/floor/tiled/steel,
/area/deepmaint)
"Qy" = (
/obj/structure/bed/chair/office/dark,
/turf/simulated/floor/tiled/steel,
/area/deepmaint)
"Rl" = (
/obj/machinery/door/blast/regular/open,
/obj/structure/catwalk,
/turf/simulated/floor/reinforced,
/area/deepmaint)
"Sg" = (
/obj/random/cluster/psi_monster/low_chance,
/obj/machinery/light/small{
	dir = 4;
	pixel_y = 0
	},
/turf/simulated/floor/tiled/steel,
/area/deepmaint)
"SI" = (
/obj/structure/closet/secure_closet/freezer/blood,
/turf/simulated/floor/tiled/steel/techfloor,
/area/deepmaint)
"TU" = (
/obj/machinery/door/blast/regular,
/obj/structure/catwalk,
/turf/simulated/floor/reinforced,
/area/deepmaint)
"Up" = (
/obj/machinery/gibber/autogibber,
/turf/simulated/floor/tiled/steel/techfloor,
/area/deepmaint)
"Ut" = (
/turf/simulated/floor/reinforced,
/area/deepmaint)
"UV" = (
/obj/effect/decal/cleanable/blood/gibs,
/turf/simulated/floor/tiled/steel,
/area/deepmaint)
"UY" = (
/obj/machinery/door/airlock/highsecurity,
/turf/simulated/floor/tiled/steel,
/area/deepmaint)
"Vb" = (
/obj/machinery/light/small{
	dir = 4
	},
/turf/simulated/floor/reinforced,
/area/deepmaint)
"Ve" = (
/obj/effect/decal/cleanable/blood/gibs,
/obj/machinery/light/small{
	dir = 4
	},
/turf/simulated/floor/reinforced,
/area/deepmaint)
"Vi" = (
/obj/effect/floor_decal/industrial/warning{
	dir = 8
	},
/obj/effect/floor_decal/industrial/warning{
	dir = 1
	},
/obj/effect/floor_decal/industrial/warning{
	dir = 4
	},
/obj/structure/closet/secure_closet/freezer,
/turf/simulated/floor/tiled/steel,
/area/deepmaint)
"Vp" = (
/obj/effect/window_lwall_spawn/plasma/reinforced,
/turf/simulated/floor/tiled/white/brown_perforated,
/area/deepmaint)
"Wy" = (
/turf/simulated/wall/r_wall,
/area/deepmaint)
"Xh" = (
/obj/item/material/shard/shrapnel/scrap,
/obj/item/material/shard/shrapnel/scrap,
/obj/item/material/shard/shrapnel/scrap,
/turf/simulated/floor/reinforced,
/area/deepmaint)
"XQ" = (
/obj/effect/floor_decal/industrial/warning{
	dir = 1
	},
/obj/effect/decal/cleanable/blood/splatter,
/turf/simulated/floor/tiled/steel,
/area/deepmaint)
"YQ" = (
/obj/effect/floor_decal/industrial/warning{
	dir = 8
	},
/turf/simulated/floor/tiled/steel,
/area/deepmaint)
"ZF" = (
/obj/random/scrap/dense_weighted,
/turf/simulated/floor/reinforced,
/area/deepmaint)

(1,1,1) = {"
IC
IC
IC
nC
IC
IC
IC
IC
IC
IC
IC
IC
as
nC
nC
IC
IC
IC
nC
nC
nC
"}
(2,1,1) = {"
IC
nC
nC
nC
IC
IC
oc
IC
IC
nC
nC
IC
IC
IC
IC
Sg
IC
IC
IC
IC
IC
"}
(3,1,1) = {"
IC
IC
Wy
Wy
Wy
Wy
Wy
Wy
Wy
Wy
Wy
Xh
Wy
Wy
Wy
Wy
Wy
Wy
Wy
IC
IC
"}
(4,1,1) = {"
IC
IC
Wy
Ut
gB
Ut
oW
Ut
gB
Ut
oW
rO
gB
Ut
Wy
sn
er
ze
Wy
IC
IC
"}
(5,1,1) = {"
IC
nw
Wy
Ut
Am
Ut
oW
Ut
Am
Ut
oW
Ut
tZ
Ut
Wy
ax
eD
IS
Wy
IC
IC
"}
(6,1,1) = {"
IC
lK
Wy
Ut
Ut
Ut
oW
Ut
Ut
Ut
oW
Ut
rO
Ut
Wy
mF
jI
Pd
Wy
Lf
IC
"}
(7,1,1) = {"
nC
IC
Wy
CX
TU
CX
oW
CX
TU
CX
oW
CX
Rl
CX
Wy
My
Ut
fZ
Wy
IC
IC
"}
(8,1,1) = {"
IC
IC
Wy
Vi
YQ
YQ
tP
YQ
YQ
pt
IK
YQ
YQ
Ol
Vp
yy
Ut
eF
Wy
IC
nC
"}
(9,1,1) = {"
IC
Wy
Wy
Wy
zl
ey
IC
rM
UV
UV
ey
UV
IC
ct
Jn
Pp
Ut
Ut
Wy
IC
IC
"}
(10,1,1) = {"
IC
Wy
qD
Wy
zl
IC
lU
ks
gx
iY
IC
Jh
rM
lo
oW
df
sp
Up
Wy
IC
IC
"}
(11,1,1) = {"
IC
UY
IC
UY
XQ
UV
Qy
ey
jd
PA
ey
Do
IC
lo
TU
Ut
Qe
jL
Wy
IC
IC
"}
(12,1,1) = {"
IC
Wy
IZ
Wy
zl
ey
mv
ww
zd
Oo
IC
MA
ey
sk
oW
Ut
Ut
hP
Wy
IC
nC
"}
(13,1,1) = {"
nC
Wy
Wy
Wy
BA
IC
UV
IC
IC
UV
rM
IC
IC
lo
Vp
df
Ut
df
Wy
IC
nC
"}
(14,1,1) = {"
nC
IC
Wy
LN
Qk
Qk
cq
ei
Qk
Qk
it
Qk
Qk
Kz
Vp
df
rX
Ut
Wy
IC
nC
"}
(15,1,1) = {"
nC
IC
Wy
CX
TU
CX
oW
CX
Rl
CX
oW
CX
TU
CX
oW
Ut
Bz
df
Wy
IC
IC
"}
(16,1,1) = {"
nC
lK
Wy
Ut
Ut
Ut
oW
FA
rH
Ut
oW
ZF
Ut
ZF
oW
SI
Bb
uV
Wy
xT
IC
"}
(17,1,1) = {"
IC
IC
Wy
Ut
Am
Ut
oW
iF
vn
rp
oW
ZF
ZF
ZF
oW
db
fj
BK
Wy
IC
IC
"}
(18,1,1) = {"
IC
IC
Wy
Ut
Vb
Ut
oW
Kx
Ve
Kx
oW
ZF
rc
ZF
oW
ka
na
yW
Wy
IC
nC
"}
(19,1,1) = {"
IC
IC
Wy
Wy
Wy
Wy
Wy
Wy
Wy
Wy
Wy
Wy
Wy
Wy
Wy
Wy
Wy
Wy
Wy
IC
nC
"}
(20,1,1) = {"
IC
nC
IC
IC
IC
IC
dq
IC
IC
IC
IC
IC
IC
IC
IC
dq
nC
IC
IC
IC
nC
"}
(21,1,1) = {"
IC
IC
IC
nC
nC
IC
nw
IC
nC
nC
IC
IC
IC
nC
nC
nC
IC
IC
IC
IC
IC
"}
