//MAP CONVERTED BY dmm2tgm.py THIS HEADER COMMENT PREVENTS RECONVERSION, DO NOT REMOVE
"am" = (
/obj/random/mob/roomba/any,
/turf/simulated/floor/asteroid/grass,
/area/space)
"ao" = (
/obj/effect/floor_decal/industrial/warning,
/obj/machinery/light/small{
	dir = 4
	},
/turf/simulated/floor/tiled/steel,
/area/space)
"aJ" = (
/obj/structure/flora/ausbushes/grassybush,
/turf/simulated/floor/asteroid/grass,
/area/space)
"aM" = (
/obj/structure/sign/faction/one_star,
/turf/simulated/wall/untinted/onestar_reinforced,
/area/space)
"aO" = (
/obj/structure/window/basic{
	dir = 4;
	icon_state = "window"
	},
/obj/effect/decal/cleanable/dirt,
/turf/simulated/floor/tiled/steel,
/area/space)
"aP" = (
/obj/structure/table/rack/shelf,
/obj/random/gun_cheap/low_chance,
/obj/random/gun_cheap/low_chance,
/obj/random/gun_cheap/low_chance,
/turf/simulated/floor/tiled/techmaint_perforated,
/area/space)
"aQ" = (
/obj/structure/flora/ausbushes/lavendergrass,
/turf/simulated/floor/asteroid/grass,
/area/space)
"bh" = (
/obj/effect/decal/cleanable/dirt,
/obj/structure/table/onestar,
/obj/random/material_resources,
/obj/random/material_resources,
/obj/random/material_resources,
/turf/simulated/floor/tiled/dark,
/area/space)
"bt" = (
/obj/effect/decal/cleanable/dirt,
/obj/random/mob/roomba/range,
/turf/simulated/floor/tiled/dark,
/area/space)
"bE" = (
/obj/structure/salvageable/os/power,
/turf/simulated/floor/tiled/techmaint_panels,
/area/space)
"bN" = (
/obj/effect/decal/cleanable/dirt,
/obj/effect/decal/cleanable/dirt,
/obj/effect/decal/cleanable/generic,
/obj/item/trash/material/device,
/obj/item/stock_parts/scanning_module/one_star,
/turf/simulated/floor/tiled/dark,
/area/space)
"bP" = (
/obj/structure/flora/small/grassa1,
/obj/structure/flora/small/bushc3,
/turf/simulated/floor/asteroid/grass,
/area/space)
"cc" = (
/obj/effect/decal/cleanable/dirt,
/obj/item/trash/material/metal,
/turf/simulated/floor/tiled/dark,
/area/space)
"cd" = (
/obj/effect/decal/cleanable/dirt,
/turf/simulated/floor/wood/wild5,
/area/space)
"cg" = (
/obj/effect/decal/cleanable/dirt,
/obj/machinery/light/small{
	dir = 4
	},
/obj/random/mob/roomba/melee,
/turf/simulated/floor/tiled/cafe,
/area/space)
"cH" = (
/obj/effect/decal/cleanable/dirt,
/obj/structure/salvageable/os/power,
/turf/simulated/floor/tiled/techmaint_panels,
/area/space)
"cP" = (
/obj/random/medical/low_chance,
/obj/random/medical/low_chance,
/obj/random/medical_lowcost/low_chance,
/obj/structure/table/onestar,
/turf/simulated/floor/tiled/techmaint,
/area/space)
"cZ" = (
/obj/structure/flora/ausbushes/ywflowers,
/turf/simulated/floor/asteroid/grass,
/area/space)
"dp" = (
/obj/structure/table/rack/shelf,
/obj/random/knife/low_chance,
/obj/random/knife/low_chance,
/obj/random/knife/low_chance,
/obj/effect/decal/cleanable/dirt,
/turf/simulated/floor/tiled/techmaint_perforated,
/area/space)
"dz" = (
/obj/machinery/vending/one_star/food,
/turf/simulated/floor/wood/wild5,
/area/space)
"dI" = (
/obj/structure/flora/ausbushes/grassybush,
/turf/simulated/floor/asteroid/dirt,
/area/space)
"eh" = (
/obj/structure/flora/small/grassb5,
/obj/random/flora/jungle_tree,
/obj/structure/flora/small/bushc3,
/turf/simulated/floor/asteroid/grass,
/area/space)
"ep" = (
/obj/effect/floor_decal/industrial/warning{
	dir = 1;
	icon_state = "warning"
	},
/turf/simulated/floor/tiled/steel,
/area/space)
"eq" = (
/obj/structure/window/basic,
/obj/effect/decal/cleanable/dirt,
/obj/random/turret/os,
/turf/simulated/floor/tiled/dark,
/area/space)
"er" = (
/obj/structure/table/standard,
/turf/simulated/floor/tiled/steel,
/area/space)
"eu" = (
/obj/machinery/mech_recharger,
/obj/random/mecha/low_chance,
/turf/simulated/floor/tiled/techmaint_panels,
/area/space)
"eH" = (
/obj/effect/decal/cleanable/dirt,
/obj/item/stock_parts/matter_bin/one_star,
/turf/simulated/floor/tiled/dark,
/area/space)
"fi" = (
/obj/effect/decal/cleanable/generic,
/obj/landmark/storyevent/midgame_stash_spawn,
/turf/simulated/floor/tiled/steel,
/area/space)
"fE" = (
/obj/structure/flora/ausbushes/stalkybush,
/turf/simulated/floor/asteroid/grass,
/area/space)
"fP" = (
/obj/structure/table/rack/shelf,
/obj/random/rig/low_chance,
/turf/simulated/floor/tiled/techmaint,
/area/space)
"gd" = (
/obj/structure/table/onestar,
/obj/random/material_resources,
/obj/random/material_resources,
/obj/random/material_resources,
/obj/random/material_resources,
/turf/simulated/floor/tiled/dark,
/area/space)
"gD" = (
/turf/simulated/floor/asteroid/grass,
/area/space)
"gL" = (
/obj/structure/salvageable/autolathe_os,
/obj/item/oddity/common/disk,
/turf/simulated/floor/tiled/dark,
/area/space)
"hz" = (
/obj/structure/window/basic{
	dir = 4;
	icon_state = "window"
	},
/obj/random/structures/os,
/turf/simulated/floor/tiled/steel,
/area/space)
"ij" = (
/obj/structure/table/woodentable,
/obj/machinery/microwave,
/turf/simulated/floor/wood/wild5,
/area/space)
"in" = (
/obj/structure/flora/ausbushes/palebush,
/turf/simulated/floor/asteroid/grass,
/area/space)
"iK" = (
/obj/random/powercell/low_chance,
/obj/random/powercell/low_chance,
/obj/random/medical_lowcost/low_chance,
/obj/effect/decal/cleanable/dirt,
/obj/structure/table/onestar,
/turf/simulated/floor/tiled/techmaint,
/area/space)
"jr" = (
/obj/effect/decal/cleanable/dirt,
/obj/machinery/door/airlock/multi_tile/metal/mait{
	dir = 1;
	icon_state = "door_closed";
	name = "Lost Outpost"
	},
/turf/simulated/floor/tiled/techmaint_perforated,
/area/space)
"jA" = (
/obj/machinery/recharger,
/obj/effect/decal/cleanable/dirt,
/obj/structure/table/onestar,
/turf/simulated/floor/tiled/techmaint_cargo,
/area/space)
"ku" = (
/obj/structure/window/basic,
/obj/effect/decal/cleanable/dirt,
/obj/structure/table/onestar,
/obj/random/lathe_disk/advanced/onestar/low_chance,
/turf/simulated/floor/tiled/dark,
/area/space)
"lE" = (
/obj/random/mob/roomba/any,
/turf/simulated/floor/tiled/steel,
/area/space)
"ma" = (
/obj/effect/decal/cleanable/dirt,
/obj/random/lathe_disk/advanced/onestar/low_chance,
/turf/simulated/floor/tiled/dark,
/area/space)
"my" = (
/obj/effect/decal/cleanable/dirt,
/turf/simulated/floor/tiled/techmaint,
/area/space)
"mD" = (
/obj/structure/table/onestar,
/obj/random/material,
/obj/random/material,
/obj/random/material,
/turf/simulated/floor/tiled/dark,
/area/space)
"mH" = (
/obj/structure/flora/small/busha1,
/turf/simulated/floor/asteroid/grass,
/area/space)
"mW" = (
/obj/machinery/door/airlock/maintenance_interior,
/obj/effect/decal/cleanable/dirt,
/turf/simulated/floor/tiled/cafe,
/area/space)
"nb" = (
/obj/structure/table/onestar,
/obj/item/stack/os_cash/random,
/turf/simulated/floor/tiled/techmaint_cargo,
/area/space)
"ns" = (
/obj/structure/table/rack/shelf,
/obj/random/ammo/low_chance,
/obj/random/ammo/low_chance,
/obj/random/ammo/shotgun/low_chance,
/obj/effect/decal/cleanable/dirt,
/turf/simulated/floor/tiled/techmaint_perforated,
/area/space)
"nv" = (
/obj/structure/closet/onestar/tier1/medical,
/turf/simulated/floor/tiled/steel,
/area/space)
"od" = (
/obj/effect/decal/cleanable/dirt,
/obj/effect/decal/cleanable/dirt,
/obj/item/stack/rods/random,
/turf/simulated/floor/tiled/dark,
/area/space)
"oh" = (
/obj/structure/bed/chair{
	dir = 4
	},
/obj/effect/decal/cleanable/dirt,
/turf/simulated/floor/tiled/techmaint,
/area/space)
"oi" = (
/obj/structure/table/standard,
/obj/random/material_resources/low_chance,
/obj/random/material_resources/low_chance,
/turf/simulated/floor/tiled/techmaint,
/area/space)
"oX" = (
/obj/structure/flora/small/bushc3,
/turf/simulated/floor/asteroid/grass,
/area/space)
"pg" = (
/obj/structure/table/standard,
/obj/random/tool_upgrade/low_chance,
/obj/random/tool_upgrade/low_chance,
/obj/random/tool_upgrade/low_chance,
/obj/random/tool_upgrade/low_chance,
/obj/effect/decal/cleanable/dirt,
/turf/simulated/floor/tiled/techmaint_cargo,
/area/space)
"pj" = (
/obj/machinery/door/airlock/multi_tile/metal/mait{
	dir = 2;
	icon_state = "door_closed";
	name = "Airlock"
	},
/obj/effect/decal/cleanable/dirt,
/turf/simulated/floor/tiled/steel,
/area/space)
"pv" = (
/obj/random/medical/low_chance,
/obj/random/medical/low_chance,
/obj/effect/decal/cleanable/dirt,
/obj/structure/table/onestar,
/obj/item/stack/os_cash/random,
/turf/simulated/floor/tiled/techmaint,
/area/space)
"pz" = (
/turf/simulated/floor/tiled/steel,
/area/space)
"pM" = (
/obj/structure/flora/ausbushes/sparsegrass,
/turf/simulated/floor/asteroid/grass,
/area/space)
"pV" = (
/obj/machinery/door/airlock/maintenance_interior{
	name = "Airlock"
	},
/obj/effect/decal/cleanable/dirt,
/turf/simulated/floor/tiled/techmaint_perforated,
/area/space)
"qn" = (
/obj/effect/decal/cleanable/dirt,
/obj/random/mob/roomba/any,
/turf/simulated/floor/tiled/steel,
/area/space)
"qH" = (
/obj/structure/sink{
	dir = 8;
	icon_state = "sink";
	pixel_x = -12;
	pixel_y = 2
	},
/obj/effect/decal/cleanable/dirt,
/turf/simulated/floor/tiled/cafe,
/area/space)
"qJ" = (
/obj/machinery/reagentgrinder,
/obj/effect/decal/cleanable/dirt,
/obj/structure/table/onestar,
/turf/simulated/floor/tiled/techmaint,
/area/space)
"qL" = (
/obj/structure/table/onestar,
/obj/item/trash/material/circuit,
/turf/simulated/floor/tiled/dark,
/area/space)
"qM" = (
/obj/effect/floor_decal/industrial/warning/corner,
/obj/effect/decal/cleanable/dirt,
/turf/simulated/floor/tiled/steel,
/area/space)
"rm" = (
/obj/structure/flora/big/bush3,
/turf/simulated/floor/asteroid/grass,
/area/space)
"rC" = (
/obj/structure/flora/small/grassb5,
/turf/simulated/floor/asteroid/grass,
/area/space)
"rE" = (
/obj/structure/flora/ausbushes/stalkybush,
/obj/structure/flora/ausbushes/lavendergrass,
/turf/simulated/floor/asteroid/grass,
/area/space)
"rI" = (
/obj/structure/flora/small/rock5,
/turf/simulated/floor/asteroid/grass,
/area/space)
"rU" = (
/obj/random/structures/os,
/turf/simulated/floor/tiled/techmaint_panels,
/area/space)
"rX" = (
/obj/structure/flora/small/grassb5,
/turf/simulated/floor/asteroid/dirt/dust,
/area/space)
"sk" = (
/obj/structure/window/basic,
/obj/structure/closet/crate/bin,
/obj/effect/decal/cleanable/dirt,
/obj/effect/decal/cleanable/dirt,
/obj/item/trash/material/metal,
/obj/item/stock_parts/manipulator/one_star,
/turf/simulated/floor/tiled/dark,
/area/space)
"sV" = (
/obj/structure/flora/ausbushes/sparsegrass,
/obj/structure/flora/big/bush3,
/turf/simulated/floor/asteroid/grass,
/area/space)
"tl" = (
/obj/machinery/light/small{
	dir = 1
	},
/obj/random/structures/os,
/turf/simulated/floor/tiled/steel,
/area/space)
"tm" = (
/obj/item/stack/rods/random,
/turf/simulated/floor/tiled/dark,
/area/space)
"tv" = (
/obj/structure/flora/big/bush1,
/turf/simulated/floor/asteroid/grass,
/area/space)
"vb" = (
/obj/effect/decal/cleanable/dirt,
/turf/simulated/floor/tiled/dark,
/area/space)
"vg" = (
/obj/effect/floor_decal/industrial/warning/corner{
	dir = 4;
	icon_state = "warningcorner"
	},
/obj/machinery/status_display{
	density = 0;
	layer = 4;
	pixel_x = 0;
	pixel_y = 32
	},
/obj/random/structures/os,
/turf/simulated/floor/tiled/steel,
/area/space)
"vy" = (
/obj/structure/closet/crate/trashcart,
/turf/simulated/floor/asteroid/dirt,
/area/space)
"vL" = (
/obj/machinery/recharge_station,
/turf/simulated/floor/tiled/techmaint_panels,
/area/space)
"vS" = (
/obj/structure/flora/small/busha3,
/turf/simulated/floor/asteroid/grass,
/area/space)
"wG" = (
/obj/structure/closet/onestar/tier3/medical,
/turf/simulated/floor/tiled/steel,
/area/space)
"wH" = (
/obj/structure/table/woodentable,
/obj/random/rations/low_chance,
/obj/random/junkfood/low_chance,
/obj/random/junkfood/low_chance,
/obj/random/junkfood/low_chance,
/obj/random/booze/low_chance,
/obj/machinery/light/small{
	dir = 8
	},
/turf/simulated/floor/wood/wild5,
/area/space)
"wM" = (
/obj/effect/floor_decal/industrial/warning{
	dir = 4
	},
/obj/effect/decal/cleanable/dirt,
/obj/random/turret/os,
/turf/simulated/floor/tiled/steel,
/area/space)
"xm" = (
/obj/structure/table/rack/shelf,
/obj/random/ammo/low_chance,
/obj/random/ammo/shotgun/low_chance,
/obj/effect/decal/cleanable/dirt,
/turf/simulated/floor/tiled/techmaint_perforated,
/area/space)
"xM" = (
/obj/effect/decal/cleanable/dirt,
/obj/item/trash/material/metal,
/obj/random/structures/os,
/turf/simulated/floor/tiled/dark,
/area/space)
"xU" = (
/obj/structure/window/basic{
	dir = 4;
	icon_state = "window"
	},
/obj/effect/decal/cleanable/dirt,
/obj/random/structures/os,
/turf/simulated/floor/tiled/steel,
/area/space)
"xW" = (
/obj/structure/table/rack/shelf,
/obj/random/gun_energy_cheap/low_chance,
/obj/random/gun_energy_cheap/low_chance,
/obj/effect/decal/cleanable/dirt,
/obj/random/tool/advanced/onestar,
/turf/simulated/floor/tiled/techmaint_perforated,
/area/space)
"yL" = (
/obj/effect/decal/cleanable/dirt,
/obj/machinery/light/small{
	dir = 4
	},
/turf/simulated/floor/wood/wild5,
/area/space)
"zx" = (
/obj/structure/closet/onestar/tier1/normal,
/turf/simulated/floor/tiled/steel,
/area/space)
"zA" = (
/obj/structure/bed/chair{
	dir = 8
	},
/turf/simulated/floor/tiled/techmaint,
/area/space)
"zG" = (
/obj/structure/flora/ausbushes/pointybush,
/turf/simulated/floor/asteroid/grass,
/area/space)
"zJ" = (
/obj/effect/decal/cleanable/dirt,
/obj/random/structures/os,
/turf/simulated/floor/tiled/steel,
/area/space)
"Ag" = (
/turf/simulated/floor/asteroid/dirt,
/area/space)
"Ah" = (
/obj/structure/closet/onestar/tier1/special,
/turf/simulated/floor/tiled/steel,
/area/space)
"Au" = (
/obj/effect/decal/cleanable/dirt,
/obj/effect/decal/cleanable/dirt,
/obj/random/mob/roomba/mecha,
/turf/simulated/floor/tiled/dark,
/area/space)
"Ba" = (
/obj/machinery/light/small,
/obj/machinery/vending/one_star/health,
/turf/simulated/floor/tiled/steel,
/area/space)
"Bm" = (
/obj/structure/flora/small/lavarock2,
/obj/effect/decal/cleanable/dirt,
/turf/simulated/floor/asteroid/dirt,
/area/space)
"Bo" = (
/obj/structure/window/basic,
/obj/structure/table/onestar,
/obj/random/material,
/obj/random/material,
/obj/random/material,
/turf/simulated/floor/tiled/dark,
/area/space)
"BN" = (
/obj/structure/flora/ausbushes/ywflowers,
/obj/structure/flora/big/bush2,
/turf/simulated/floor/asteroid/grass,
/area/space)
"BQ" = (
/obj/structure/bed/chair{
	dir = 8
	},
/obj/effect/decal/cleanable/dirt,
/turf/simulated/floor/tiled/techmaint,
/area/space)
"Cj" = (
/obj/random/structures/os,
/turf/simulated/floor/tiled/steel,
/area/space)
"Cz" = (
/obj/effect/decal/cleanable/dirt,
/obj/effect/decal/cleanable/generic,
/turf/simulated/floor/tiled/techmaint,
/area/space)
"CK" = (
/obj/random/flora/small_jungle_tree,
/turf/simulated/floor/asteroid/grass,
/area/space)
"CR" = (
/obj/machinery/light/small{
	dir = 4
	},
/turf/simulated/floor/wood/wild5,
/area/space)
"Da" = (
/obj/structure/flora/big/bush2,
/turf/simulated/floor/asteroid/grass,
/area/space)
"Dy" = (
/obj/structure/flora/small/bushc1,
/turf/simulated/floor/asteroid/grass,
/area/space)
"Dz" = (
/obj/random/pack/tech_loot/onestar,
/obj/structure/table/onestar,
/turf/simulated/floor/tiled/techmaint_cargo,
/area/space)
"DG" = (
/turf/simulated/floor/wood/wild5,
/area/space)
"DT" = (
/obj/structure/table/rack/shelf,
/obj/random/material_rare/low_chance,
/obj/random/material_rare/low_chance,
/obj/random/material_rare/low_chance,
/turf/simulated/floor/tiled/techmaint_cargo,
/area/space)
"En" = (
/obj/effect/floor_decal/industrial/warning{
	dir = 8;
	icon_state = "warning"
	},
/turf/simulated/floor/tiled/steel,
/area/space)
"EH" = (
/obj/structure/bed,
/turf/simulated/floor/wood/wild5,
/area/space)
"Fk" = (
/obj/machinery/recharge_station,
/obj/machinery/light/small{
	dir = 8
	},
/turf/simulated/floor/tiled/techmaint_panels,
/area/space)
"Fp" = (
/obj/effect/decal/cleanable/dirt,
/obj/effect/decal/cleanable/generic,
/turf/simulated/floor/wood/wild5,
/area/space)
"Ft" = (
/obj/effect/decal/cleanable/dirt,
/obj/item/frame/apc,
/turf/simulated/floor/tiled/steel,
/area/space)
"Fz" = (
/obj/random/flora/jungle_tree,
/turf/simulated/floor/asteroid/grass,
/area/space)
"Go" = (
/obj/structure/closet/onestar/tier2/special,
/turf/simulated/floor/wood/wild5,
/area/space)
"Gx" = (
/turf/simulated/wall/untinted/onestar_reinforced,
/area/space)
"GB" = (
/obj/random/mob/roomba/any,
/turf/simulated/floor/asteroid/dirt,
/area/space)
"Ho" = (
/obj/structure/flora/big/bush2,
/obj/structure/flora/small/busha3,
/turf/simulated/floor/asteroid/grass,
/area/space)
"Ht" = (
/obj/effect/decal/cleanable/dirt,
/turf/simulated/floor/tiled/cafe,
/area/space)
"IE" = (
/obj/effect/decal/cleanable/dirt,
/obj/machinery/light/small{
	dir = 8
	},
/turf/simulated/floor/tiled/steel,
/area/space)
"IG" = (
/obj/machinery/light/small,
/turf/simulated/floor/tiled/steel,
/area/space)
"IH" = (
/obj/random/junk/low_chance,
/obj/effect/decal/cleanable/dirt,
/turf/simulated/floor/tiled/steel,
/area/space)
"IM" = (
/obj/structure/table/rack/shelf,
/obj/random/gun_cheap/low_chance,
/obj/random/gun_cheap/low_chance,
/obj/effect/decal/cleanable/dirt,
/obj/random/pack/tech_loot/onestar,
/turf/simulated/floor/tiled/techmaint_perforated,
/area/space)
"JE" = (
/obj/structure/flora/small/grassb5,
/obj/random/mob/roomba/any,
/turf/simulated/floor/asteroid/grass,
/area/space)
"Ko" = (
/obj/effect/decal/cleanable/dirt,
/turf/simulated/floor/tiled/steel,
/area/space)
"Ks" = (
/obj/effect/decal/cleanable/dirt,
/obj/effect/decal/cleanable/dirt,
/turf/simulated/floor/tiled/dark,
/area/space)
"Ky" = (
/obj/structure/toilet{
	dir = 4
	},
/obj/effect/decal/cleanable/dirt,
/obj/landmark/storyevent/midgame_stash_spawn,
/turf/simulated/floor/tiled/cafe,
/area/space)
"KC" = (
/obj/machinery/door/airlock/multi_tile/metal/mait,
/obj/effect/decal/cleanable/dirt,
/turf/simulated/floor/tiled/techmaint_perforated,
/area/space)
"KV" = (
/obj/effect/decal/cleanable/dirt,
/obj/random/mob/roomba/any,
/turf/simulated/floor/tiled/techmaint,
/area/space)
"Lz" = (
/obj/structure/closet/crate/bin,
/turf/simulated/floor/wood/wild5,
/area/space)
"LA" = (
/obj/structure/flora/small/grassa1,
/turf/simulated/floor/asteroid/grass,
/area/space)
"LP" = (
/obj/effect/decal/cleanable/dirt,
/turf/simulated/floor/tiled/techmaint_perforated,
/area/space)
"LQ" = (
/obj/structure/table/woodentable,
/obj/random/rations/low_chance,
/obj/random/rations/low_chance,
/obj/random/junkfood/low_chance,
/obj/random/junkfood/low_chance,
/obj/random/booze/low_chance,
/turf/simulated/floor/wood/wild5,
/area/space)
"MD" = (
/obj/structure/flora/ausbushes/grassybush,
/obj/random/mob/roomba/any,
/turf/simulated/floor/asteroid/dirt,
/area/space)
"Na" = (
/obj/structure/flora/small/grassb5,
/obj/structure/flora/big/bush2,
/turf/simulated/floor/asteroid/grass,
/area/space)
"NR" = (
/obj/structure/table/onestar,
/obj/random/lathe_disk/advanced/onestar/low_chance,
/obj/item/stock_parts/capacitor/one_star,
/turf/simulated/floor/tiled/dark,
/area/space)
"Oj" = (
/obj/random/powercell/low_chance,
/obj/effect/decal/cleanable/dirt,
/obj/structure/table/onestar,
/turf/simulated/floor/tiled/techmaint,
/area/space)
"Ol" = (
/obj/structure/table/rack/shelf,
/obj/random/rig/damaged/low_chance,
/obj/machinery/light/small,
/turf/simulated/floor/tiled/techmaint,
/area/space)
"Om" = (
/obj/random/mob/roomba/any,
/turf/simulated/floor/tiled/techmaint,
/area/space)
"OI" = (
/obj/machinery/light/small{
	dir = 1
	},
/obj/structure/closet/onestar/tier3/medical,
/turf/simulated/floor/tiled/steel,
/area/space)
"OJ" = (
/obj/random/turret/os,
/turf/simulated/floor/asteroid/dirt,
/area/space)
"OZ" = (
/obj/effect/decal/cleanable/dirt,
/obj/random/mob/roomba/any,
/turf/simulated/floor/wood/wild5,
/area/space)
"Pf" = (
/obj/random/pouch/low_chance,
/obj/random/pouch/low_chance,
/obj/structure/table/onestar,
/turf/simulated/floor/tiled/techmaint,
/area/space)
"Px" = (
/obj/effect/window_lwall_spawn/smartspawn/onestar,
/turf/simulated/floor/plating/under,
/area/space)
"PA" = (
/obj/effect/decal/cleanable/dirt,
/obj/structure/closet/onestar/tier1/normal,
/turf/simulated/floor/tiled/steel,
/area/space)
"PF" = (
/obj/effect/decal/cleanable/dirt,
/obj/random/mob/roomba/range,
/turf/simulated/floor/tiled/steel,
/area/space)
"PN" = (
/obj/structure/flora/ausbushes/grassybush,
/obj/random/spider_trap_burrowing/low_chance,
/turf/simulated/floor/asteroid/grass,
/area/space)
"QN" = (
/obj/effect/floor_decal/industrial/warning/corner{
	dir = 1;
	icon_state = "warningcorner"
	},
/obj/effect/decal/cleanable/dirt,
/obj/random/mob/roomba/any,
/turf/simulated/floor/tiled/steel,
/area/space)
"Rn" = (
/obj/structure/flora/ausbushes/lavendergrass,
/turf/simulated/floor/asteroid/dirt,
/area/space)
"RE" = (
/obj/structure/reagent_dispensers/water_cooler,
/obj/effect/decal/cleanable/dirt,
/turf/simulated/floor/wood/wild5,
/area/space)
"RH" = (
/turf/simulated/floor/asteroid/dirt/dust,
/area/space)
"RW" = (
/obj/effect/decal/cleanable/dirt,
/obj/effect/decal/cleanable/generic,
/turf/simulated/floor/tiled/steel,
/area/space)
"RZ" = (
/obj/effect/decal/cleanable/dirt,
/obj/machinery/vending/one_star/guns,
/turf/simulated/floor/tiled/techmaint_perforated,
/area/space)
"Sp" = (
/obj/structure/table/rack/shelf,
/obj/random/gun_shotgun,
/obj/random/gun_shotgun/low_chance,
/obj/random/gun_shotgun/low_chance,
/obj/effect/decal/cleanable/dirt,
/turf/simulated/floor/tiled/techmaint_perforated,
/area/space)
"Tj" = (
/obj/structure/table/rack/shelf,
/obj/random/ammo_lowcost/low_chance,
/obj/random/ammo_lowcost/low_chance,
/obj/random/ammo/shotgun/low_chance,
/obj/effect/decal/cleanable/dirt,
/turf/simulated/floor/tiled/techmaint_perforated,
/area/space)
"Tp" = (
/obj/structure/bed/chair{
	dir = 4
	},
/turf/simulated/floor/tiled/techmaint,
/area/space)
"Ux" = (
/obj/machinery/vending/cigarette,
/turf/simulated/floor/wood/wild5,
/area/space)
"UG" = (
/obj/structure/flora/small/bushb3,
/turf/simulated/floor/asteroid/grass,
/area/space)
"UH" = (
/obj/effect/decal/cleanable/dirt,
/obj/landmark/storyevent/midgame_stash_spawn,
/turf/simulated/floor/tiled/steel,
/area/space)
"UR" = (
/obj/structure/table/woodentable,
/obj/item/storage/box/donkpockets,
/obj/item/stack/os_cash/random,
/turf/simulated/floor/wood/wild5,
/area/space)
"UU" = (
/obj/structure/salvageable/autolathe_os,
/obj/random/lathe_disk/advanced/onestar,
/turf/simulated/floor/tiled/dark,
/area/space)
"Vp" = (
/turf/simulated/floor/tiled/techmaint,
/area/space)
"VT" = (
/obj/structure/table/rack/shelf,
/obj/random/gun_shotgun/low_chance,
/obj/random/gun_shotgun/low_chance,
/obj/effect/decal/cleanable/dirt,
/obj/random/pack/tech_loot/onestar,
/turf/simulated/floor/tiled/techmaint_perforated,
/area/space)
"Xb" = (
/obj/machinery/recharger,
/obj/effect/decal/cleanable/dirt,
/obj/machinery/light/small,
/obj/structure/table/onestar,
/turf/simulated/floor/tiled/techmaint_cargo,
/area/space)
"Xs" = (
/obj/machinery/door/airlock/multi_tile/metal/mait{
	name = "Lost Outpost"
	},
/obj/effect/decal/cleanable/dirt,
/turf/simulated/floor/tiled/techmaint_perforated,
/area/space)
"Xz" = (
/obj/structure/flora/ausbushes/sparsegrass,
/turf/simulated/floor/asteroid/dirt,
/area/space)
"XF" = (
/obj/structure/flora/small/grassb1,
/turf/simulated/floor/asteroid/grass,
/area/space)
"YL" = (
/obj/structure/table/rack/shelf,
/obj/random/toolbox/low_chance,
/obj/random/toolbox/low_chance,
/obj/random/toolbox/low_chance,
/turf/simulated/floor/tiled/techmaint_panels,
/area/space)
"YM" = (
/obj/effect/floor_decal/industrial/warning{
	dir = 8;
	icon_state = "warning"
	},
/obj/effect/decal/cleanable/dirt,
/turf/simulated/floor/tiled/steel,
/area/space)
"Zh" = (
/obj/machinery/power/port_gen/os_generator,
/turf/simulated/floor/tiled/techmaint_cargo,
/area/space)
"Zi" = (
/obj/structure/table/onestar,
/turf/simulated/floor/tiled/steel,
/area/space)
"Zk" = (
/obj/effect/floor_decal/industrial/warning,
/obj/effect/decal/cleanable/dirt,
/turf/simulated/floor/tiled/steel,
/area/space)
"Zt" = (
/obj/effect/decal/cleanable/dirt,
/obj/machinery/light/small{
	dir = 1
	},
/obj/structure/closet/onestar/tier3/mineral,
/turf/simulated/floor/tiled/steel,
/area/space)
"ZJ" = (
/obj/structure/table/rack/shelf,
/obj/random/gun_energy_cheap/low_chance,
/obj/random/gun_energy_cheap/low_chance,
/obj/random/gun_energy_cheap/low_chance,
/obj/effect/decal/cleanable/dirt,
/obj/random/tool/advanced/onestar,
/turf/simulated/floor/tiled/techmaint_perforated,
/area/space)
"ZS" = (
/obj/effect/decal/cleanable/dirt,
/obj/machinery/door/airlock/multi_tile/metal/mait{
	name = "Lost Outpost"
	},
/turf/simulated/floor/tiled/techmaint_perforated,
/area/space)

(1,1,1) = {"
Ag
Ag
Ag
Ag
Rn
fE
cZ
cZ
zG
zG
cZ
cZ
cZ
cZ
gD
rC
eh
rX
gD
rm
Gx
Px
Px
aM
Px
Px
aM
Px
Px
Gx
"}
(2,1,1) = {"
Bm
Ag
Ag
Rn
rE
in
am
gD
zG
gD
XF
gD
gD
gD
gD
Na
Ag
rX
Na
rI
Gx
Cj
zJ
nv
zx
zx
Cj
Cj
Cj
Gx
"}
(3,1,1) = {"
fE
Ag
Ag
Ag
aQ
gD
gD
vS
gD
gD
gD
gD
gD
vS
JE
gD
RH
RH
rC
oX
Gx
Cj
Ko
qn
RW
Ko
Ko
Ko
Zi
Gx
"}
(4,1,1) = {"
gD
Ag
Ag
Ag
gD
gD
vS
aM
Gx
Gx
Gx
Px
Px
Px
Px
Gx
LP
jr
Gx
Gx
Gx
tl
Ko
ZJ
RZ
xW
Ko
qn
Dz
aM
"}
(5,1,1) = {"
gD
Ag
Ag
Ag
gD
pM
gD
Gx
qH
Ky
Gx
ij
UR
wH
LQ
Px
Om
Vp
er
wG
Px
zJ
Ko
aP
IM
Tj
pz
Ko
jA
Gx
"}
(6,1,1) = {"
gD
Ag
GB
Ag
pM
pM
gD
Gx
cg
Ht
Gx
cd
cd
OZ
cd
aM
Ko
pz
pz
pz
Px
zJ
pz
lE
Ko
Ko
fi
Ko
Xb
Gx
"}
(7,1,1) = {"
gD
Ag
Ag
Ag
pM
pM
pM
Gx
aM
mW
Gx
RE
cd
cd
cd
pV
Ko
Cz
my
IG
Gx
zJ
Ko
Ko
PF
Ko
Ko
Ko
Dz
Gx
"}
(8,1,1) = {"
gD
Ag
Ag
Ag
pM
pM
am
Gx
Ux
OZ
cd
cd
OZ
cd
cd
Px
Cj
my
my
Ko
aM
Cj
Ko
Sp
VT
xm
qn
Ko
nb
aM
"}
(9,1,1) = {"
pM
Ag
Ag
Ag
aQ
pM
gD
Gx
Lz
yL
cd
DG
DG
dz
dz
Px
Cj
my
KV
RW
KC
qn
Ko
dp
RZ
ns
Ko
Ko
Dz
Gx
"}
(10,1,1) = {"
gD
Ag
Ag
Ag
pM
pM
Ag
aM
Gx
Gx
Px
Px
Gx
Gx
Gx
Gx
vg
Ko
Ko
Ko
LP
Ko
pz
pz
Ko
Ko
RW
Ko
zx
Gx
"}
(11,1,1) = {"
gD
Ag
Ag
Ag
Xz
pM
Xz
Xz
Xz
Xz
Xz
Xz
aM
vL
Fk
eu
ep
Ko
Ko
pz
aM
Ah
Ah
zx
zx
PA
zJ
zJ
Cj
Gx
"}
(12,1,1) = {"
gD
Ag
Ag
Ag
Xz
dI
aJ
dI
dI
dI
dI
MD
Gx
En
En
YM
QN
Ko
qn
oi
Gx
Px
Px
aM
Px
Px
aM
Px
Px
Gx
"}
(13,1,1) = {"
gD
Ag
Ag
Ag
Ag
Ag
Ag
Ag
Ag
Ag
Ag
Ag
Xs
Ko
qn
RW
Ko
Ko
Ko
Ol
Gx
bP
LA
LA
LA
Da
vS
gD
Da
gD
"}
(14,1,1) = {"
gD
Ag
Ag
Ag
Ag
Ag
Ag
Ag
Ag
GB
Ag
Ag
LP
Ko
Ko
Ko
pz
pz
pz
fP
Gx
vS
oX
vS
gD
gD
gD
gD
gD
gD
"}
(15,1,1) = {"
gD
gD
Ag
Ag
Ag
Ag
Ag
Ag
Ag
Ag
Ag
OJ
Gx
Gx
aM
Gx
Ko
pj
Gx
Gx
Gx
LA
oX
am
Da
vS
gD
Da
gD
gD
"}
(16,1,1) = {"
gD
gD
gD
gD
Ag
Ag
Ag
Ag
Ag
Ag
Ag
Ag
ZS
Ko
Ko
IE
Ko
Ko
Cj
Cj
Gx
gD
CK
gD
gD
vS
gD
gD
gD
gD
"}
(17,1,1) = {"
gD
gD
gD
gD
gD
gD
Ag
Ag
Ag
Ag
Ag
Ag
LP
Ko
RW
qn
Ko
Ko
Ko
Cj
Gx
Gx
Gx
aM
Gx
Gx
gD
am
gD
Da
"}
(18,1,1) = {"
gD
gD
BN
cZ
cZ
PN
PN
aJ
aJ
dI
Ag
Ag
Gx
zJ
my
Tp
Tp
oh
KV
pz
Gx
Zh
pz
UH
DT
Px
vS
gD
gD
gD
"}
(19,1,1) = {"
CK
cZ
cZ
gD
gD
gD
gD
am
gD
aJ
Ag
vy
aM
OI
my
cP
pv
Pf
my
Ba
Gx
pg
Ko
Ko
DT
Px
gD
gD
gD
gD
"}
(20,1,1) = {"
gD
gD
pM
gD
pM
pM
gD
gD
gD
aJ
Ag
vy
Gx
wG
my
qJ
Oj
iK
my
pz
Gx
Zt
Ko
Ko
PF
Px
gD
gD
gD
gD
"}
(21,1,1) = {"
gD
sV
pM
pM
pM
gD
gD
aM
Gx
Px
Px
Px
Gx
Cj
my
zA
zA
BQ
my
Ko
pV
Ko
RW
qM
wM
aM
gD
gD
gD
gD
"}
(22,1,1) = {"
gD
pM
pM
pM
CK
gD
Da
Gx
qL
bt
xM
mD
Bo
Ko
IH
PF
Ko
RW
Ko
Cj
Gx
Ft
Ko
Zk
cH
Px
gD
Da
gD
gD
"}
(23,1,1) = {"
gD
tv
pM
pM
gD
gD
gD
Px
NR
tm
bN
Ks
ma
Ko
Ko
aO
aO
aO
xU
hz
Gx
YL
Ko
Zk
bE
Px
gD
gD
rI
gD
"}
(24,1,1) = {"
Dy
gD
gD
pM
gD
gD
gD
Px
UU
cc
Au
od
sk
Cj
Ko
cd
cd
Fp
OZ
DG
Gx
rU
Cj
ao
bE
Px
gD
gD
gD
gD
"}
(25,1,1) = {"
Dy
gD
am
pM
gD
gD
gD
Px
bh
eH
ma
vb
eq
Cj
Ko
cd
cd
DG
DG
DG
Gx
Gx
Gx
aM
Gx
Gx
gD
am
gD
gD
"}
(26,1,1) = {"
tv
Dy
gD
gD
Fz
gD
gD
Gx
gd
bh
gL
bt
ku
Cj
pz
CR
EH
Go
EH
Go
Gx
Ho
vS
vS
gD
gD
gD
gD
gD
gD
"}
(27,1,1) = {"
tv
gD
gD
gD
Da
gD
gD
aM
Gx
Px
Px
Px
Gx
Gx
Gx
aM
Gx
Gx
Gx
Gx
aM
vS
vS
am
gD
gD
gD
UG
UG
vS
"}
(28,1,1) = {"
gD
gD
UG
UG
gD
gD
gD
gD
gD
gD
gD
am
gD
gD
gD
gD
gD
gD
gD
gD
vS
vS
gD
gD
gD
gD
UG
UG
gD
gD
"}
(29,1,1) = {"
mH
mH
gD
gD
gD
am
gD
gD
gD
gD
gD
gD
gD
gD
gD
gD
gD
am
gD
gD
gD
gD
gD
gD
tv
gD
gD
gD
gD
Da
"}
(30,1,1) = {"
gD
gD
gD
gD
gD
gD
gD
gD
gD
gD
gD
gD
gD
gD
gD
gD
gD
gD
gD
gD
gD
gD
gD
gD
gD
gD
tv
Da
gD
gD
"}
