"aa" = (/mob/living/simple_animal/hostile/carp/pike,/turf/unsimulated/floor{icon_state = "lino"},/area/template_noop)
"ab" = (/mob/living/simple_animal/hostile/carp/pike,/turf/unsimulated/floor{icon_state = "cult"; name = "plating"},/area/template_noop)
"ac" = (/mob/living/simple_animal/hostile/carp/baby,/turf/unsimulated/floor{icon_state = "white"},/area/template_noop)
"ad" = (/mob/living/simple_animal/hostile/carp/shark,/turf/unsimulated/floor{icon_state = "white"},/area/template_noop)
"ae" = (/mob/living/simple_animal/hostile/carp/pike,/turf/unsimulated/floor{dir = 2; icon_state = "freezerfloor"},/area/template_noop)
"aw" = (/obj/random/scrap/sparse_even,/turf/simulated/floor/plating/under,/area/template_noop)
"aH" = (/obj/random/scrap/dense_weighted,/turf/simulated/floor/plating/under,/area/template_noop)
"aJ" = (/obj/structure/closet,/obj/item/clothing/under/turtleneck,/obj/item/clothing/under/turtleneck,/obj/item/clothing/under/turtleneck,/obj/item/clothing/under/turtleneck,/obj/item/clothing/under/turtleneck,/obj/item/clothing/shoes/magboots/merc,/obj/item/clothing/shoes/magboots/merc,/obj/item/clothing/shoes/magboots/merc,/obj/item/clothing/shoes/magboots/merc,/turf/unsimulated/floor{icon_state = "lino"},/area/template_noop)
"aK" = (/obj/structure/closet/secure_closet/freezer/kitchen{req_access = list(150)},/turf/unsimulated/floor{icon_state = "white"},/area/template_noop)
"bi" = (/turf/template_noop,/area/template_noop)
"by" = (/obj/structure/bed,/obj/item/weapon/bedsheet/hos,/obj/item/weapon/reagent_containers/food/drinks/bottle/vodka,/turf/unsimulated/floor{icon_state = "lino"},/area/template_noop)
"bB" = (/turf/simulated/floor/plating/under,/area/template_noop)
"bG" = (/obj/random/lowkeyrandom,/obj/machinery/light{dir = 1},/turf/unsimulated/floor{dir = 2; icon_state = "freezerfloor"},/area/template_noop)
"cW" = (/obj/structure/closet,/obj/item/clothing/under/turtleneck,/obj/item/clothing/under/turtleneck,/obj/item/clothing/under/turtleneck,/obj/item/clothing/under/turtleneck,/obj/item/clothing/shoes/magboots/merc,/obj/item/clothing/shoes/magboots/merc,/obj/item/clothing/shoes/magboots/merc,/turf/unsimulated/floor{icon_state = "lino"},/area/template_noop)
"du" = (/obj/machinery/shower{dir = 1},/obj/structure/curtain/open/shower,/turf/unsimulated/floor{dir = 2; icon_state = "freezerfloor"},/area/template_noop)
"dI" = (/obj/structure/table/standard,/obj/item/weapon/storage/deferred/rations,/turf/unsimulated/floor{icon_state = "cult"; name = "plating"},/area/template_noop)
"dN" = (/obj/random/junk,/turf/simulated/floor/plating/under,/area/template_noop)
"dU" = (/obj/random/junkfood/rotten,/obj/machinery/light{dir = 8},/turf/unsimulated/floor{icon_state = "cult"; name = "plating"},/area/template_noop)
"eg" = (/obj/item/weapon/storage/deferred/crate/alcohol,/obj/machinery/light{dir = 4},/turf/unsimulated/floor{icon_state = "white"},/area/template_noop)
"eo" = (/obj/item/weapon/stool,/obj/effect/decal/cleanable/vomit,/turf/unsimulated/floor{icon_state = "lino"},/area/template_noop)
"fb" = (/obj/structure/table/standard,/obj/item/weapon/reagent_containers/food/drinks/bottle/vodka{pixel_x = 5; pixel_y = 17},/obj/item/weapon/reagent_containers/food/drinks/bottle/vodka{pixel_x = 6; pixel_y = 7},/obj/item/weapon/reagent_containers/food/drinks/drinkingglass{pixel_x = -5; pixel_y = 1},/obj/item/weapon/reagent_containers/food/drinks/drinkingglass{pixel_x = -5; pixel_y = 15},/turf/unsimulated/floor{icon_state = "lino"},/area/template_noop)
"fM" = (/obj/structure/table/standard,/obj/item/weapon/reagent_containers/food/snacks/mint,/obj/item/weapon/reagent_containers/food/condiment/saltshaker{pixel_x = -3},/obj/item/weapon/reagent_containers/food/condiment/peppermill{pixel_x = 3},/turf/unsimulated/floor{icon_state = "white"},/area/template_noop)
"gN" = (/obj/structure/shuttle/engine/propulsion{icon_state = "propulsion_l"},/turf/template_noop,/area/template_noop)
"ip" = (/obj/random/scrap/dense_weighted,/turf/unsimulated/floor{icon_state = "cult"; name = "plating"},/area/template_noop)
"iw" = (/obj/machinery/light,/turf/unsimulated/floor{icon_state = "lino"},/area/template_noop)
"iY" = (/obj/structure/table/standard,/obj/item/weapon/packageWrap,/obj/item/weapon/reagent_containers/food/condiment/enzyme{layer = 5},/obj/item/weapon/reagent_containers/food/condiment/enzyme{layer = 5},/obj/structure/cable/green,/turf/unsimulated/floor{icon_state = "white"},/area/template_noop)
"js" = (/obj/structure/bed,/obj/item/weapon/bedsheet/hos,/obj/random/booze/low_chance,/turf/unsimulated/floor{icon_state = "lino"},/area/template_noop)
"jP" = (/obj/structure/table/rack,/obj/item/weapon/storage/deferred/crate/tools,/turf/unsimulated/floor{icon_state = "cult"; name = "plating"},/area/template_noop)
"kl" = (/obj/machinery/shower{pixel_y = 32},/obj/structure/window/basic{dir = 8},/obj/structure/curtain/open/shower,/turf/unsimulated/floor{dir = 2; icon_state = "freezerfloor"},/area/template_noop)
"kx" = (/obj/structure/table/rack,/obj/random/junk,/turf/unsimulated/floor{icon_state = "cult"; name = "plating"},/area/template_noop)
"kO" = (/obj/structure/table/standard,/obj/item/weapon/storage/box/drinkingglasses{pixel_x = 1; pixel_y = 4},/turf/unsimulated/floor{icon_state = "white"},/area/template_noop)
"kW" = (/turf/simulated/floor/tiled/white/techfloor_grid,/area/template_noop)
"lA" = (/obj/machinery/microwave{pixel_x = -1; pixel_y = 8},/obj/structure/table/standard,/obj/machinery/light{dir = 8},/turf/unsimulated/floor{icon_state = "white"},/area/template_noop)
"lO" = (/turf/unsimulated/floor{dir = 2; icon_state = "freezerfloor"},/area/template_noop)
"mZ" = (/obj/structure/closet/emcloset,/turf/unsimulated/floor{icon_state = "cult"; name = "plating"},/area/template_noop)
"nu" = (/obj/structure/table/rack,/obj/structure/closet/onestar/tier2/normal,/obj/machinery/light{dir = 1},/turf/unsimulated/floor{icon_state = "cult"; name = "plating"},/area/template_noop)
"oL" = (/obj/structure/closet,/obj/item/weapon/tool/pickaxe/diamonddrill,/obj/item/weapon/tool/pickaxe/diamonddrill,/obj/item/weapon/storage/backpack/military,/obj/item/weapon/storage/backpack/military,/turf/unsimulated/floor{icon_state = "cult"; name = "plating"},/area/template_noop)
"oX" = (/obj/random/junkfood/rotten,/obj/machinery/light{dir = 4},/turf/unsimulated/floor{icon_state = "cult"; name = "plating"},/area/template_noop)
"qa" = (/obj/structure/window/basic{dir = 8},/obj/machinery/shower{dir = 1},/obj/structure/curtain/open/shower,/turf/unsimulated/floor{dir = 2; icon_state = "freezerfloor"},/area/template_noop)
"qA" = (/obj/structure/closet,/obj/item/clothing/mask/balaclava/tactical,/obj/item/clothing/mask/balaclava/tactical,/obj/item/clothing/mask/balaclava/tactical,/turf/simulated/floor/plating/under,/area/template_noop)
"qL" = (/obj/item/modular_computer/console,/turf/unsimulated/floor{icon_state = "cult"; name = "plating"},/area/template_noop)
"qX" = (/obj/machinery/door/airlock/maintenance_interior,/turf/unsimulated/floor{dir = 2; icon_state = "freezerfloor"},/area/template_noop)
"rd" = (/obj/structure/bed,/obj/item/weapon/bedsheet/hos,/obj/item/clothing/head/ushanka,/turf/unsimulated/floor{icon_state = "lino"},/area/template_noop)
"ru" = (/obj/structure/shuttle/engine/heater,/obj/structure/window/reinforced/crescent{dir = 1},/turf/simulated/floor/airless,/area/template_noop)
"rL" = (/obj/item/weapon/reagent_containers/food/drinks/bottle/vodka{pixel_x = 3; pixel_y = 12},/obj/item/weapon/reagent_containers/food/drinks/bottle/wine{pixel_x = -1; pixel_y = 8},/obj/structure/table/standard,/turf/unsimulated/floor{icon_state = "white"},/area/template_noop)
"sg" = (/obj/structure/closet,/obj/random/ammo,/obj/random/ammo,/obj/random/ammo,/obj/random/ammo,/obj/machinery/light{dir = 1},/turf/unsimulated/floor{icon_state = "cult"; name = "plating"},/area/template_noop)
"ss" = (/obj/structure/table/rack,/obj/item/weapon/storage/deferred/meds,/turf/unsimulated/floor{icon_state = "cult"; name = "plating"},/area/template_noop)
"sN" = (/obj/structure/bed/chair{dir = 1},/turf/unsimulated/floor{icon_state = "cult"; name = "plating"},/area/template_noop)
"tv" = (/obj/structure/table/rack,/obj/item/weapon/gun/projectile/handmade_pistol/shotgun,/turf/unsimulated/floor{icon_state = "cult"; name = "plating"},/area/template_noop)
"tK" = (/obj/item/remains/human,/obj/item/clothing/shoes/magboots/merc,/obj/item/clothing/under/turtleneck,/obj/item/clothing/head/ushanka,/turf/unsimulated/floor{icon_state = "white"},/area/template_noop)
"um" = (/obj/item/weapon/stool,/turf/unsimulated/floor{icon_state = "cult"; name = "plating"},/area/template_noop)
"vt" = (/obj/machinery/portable_atmospherics/canister/plasma,/turf/unsimulated/floor{icon_state = "cult"; name = "plating"},/area/template_noop)
"vz" = (/obj/structure/table/standard,/obj/item/weapon/reagent_containers/glass/beaker{pixel_x = 5},/obj/item/weapon/reagent_containers/glass/beaker{pixel_x = 5},/obj/machinery/light,/obj/item/weapon/material/kitchen/rollingpin,/turf/unsimulated/floor{icon_state = "white"},/area/template_noop)
"wR" = (/obj/structure/table/rack,/obj/item/clothing/mask/gas/tactical,/obj/item/clothing/mask/gas/tactical,/obj/item/clothing/mask/gas/tactical,/obj/item/weapon/storage/pouch/large_generic,/turf/unsimulated/floor{icon_state = "cult"; name = "plating"},/area/template_noop)
"wU" = (/obj/machinery/door/airlock/maintenance_interior{icon_state = "door_locked"; locked = 1},/turf/unsimulated/floor{icon_state = "cult"; name = "plating"},/area/template_noop)
"wX" = (/obj/structure/table/standard,/obj/item/weapon/folder/cyan,/turf/unsimulated/floor{icon_state = "cult"; name = "plating"},/area/template_noop)
"xN" = (/obj/random/techpart/low_chance,/turf/unsimulated/floor{icon_state = "white"},/area/template_noop)
"yJ" = (/obj/item/weapon/stool,/obj/random/booze/low_chance,/turf/unsimulated/floor{icon_state = "cult"; name = "plating"},/area/template_noop)
"zg" = (/obj/structure/table/standard,/turf/unsimulated/floor{icon_state = "cult"; name = "plating"},/area/template_noop)
"zJ" = (/obj/item/weapon/stool,/obj/random/junkfood/rotten,/turf/unsimulated/floor{icon_state = "cult"; name = "plating"},/area/template_noop)
"zM" = (/obj/structure/table/standard,/obj/random/booze/low_chance,/turf/unsimulated/floor{icon_state = "cult"; name = "plating"},/area/template_noop)
"zT" = (/obj/structure/shuttle/engine/propulsion,/turf/template_noop,/area/template_noop)
"As" = (/obj/item/weapon/stool,/turf/unsimulated/floor{icon_state = "lino"},/area/template_noop)
"Bq" = (/obj/structure/toilet{dir = 8},/turf/unsimulated/floor{dir = 2; icon_state = "freezerfloor"},/area/template_noop)
"Bv" = (/obj/structure/bed,/obj/item/weapon/bedsheet/hos,/obj/item/clothing/under/serbiansuit/brown,/turf/unsimulated/floor{icon_state = "lino"},/area/template_noop)
"Bz" = (/obj/item/weapon/stool,/obj/random/booze/low_chance,/turf/simulated/floor/plating/under,/area/template_noop)
"BQ" = (/obj/structure/table/standard,/turf/unsimulated/floor{icon_state = "white"},/area/template_noop)
"CY" = (/obj/machinery/light,/turf/unsimulated/floor{icon_state = "cult"; name = "plating"},/area/template_noop)
"Di" = (/obj/structure/closet/firecloset,/turf/unsimulated/floor{icon_state = "cult"; name = "plating"},/area/template_noop)
"DP" = (/obj/structure/bed,/obj/item/weapon/bedsheet/hos,/turf/unsimulated/floor{icon_state = "lino"},/area/template_noop)
"Ee" = (/obj/structure/table/standard,/obj/item/weapon/paper_bin,/obj/item/weapon/pen,/turf/unsimulated/floor{icon_state = "cult"; name = "plating"},/area/template_noop)
"Eg" = (/obj/machinery/door/airlock/maintenance_interior,/turf/unsimulated/floor{icon_state = "cult"; name = "plating"},/area/template_noop)
"Eo" = (/obj/structure/bed,/obj/item/weapon/bedsheet/hos,/obj/item/clothing/under/serbiansuit,/turf/unsimulated/floor{icon_state = "lino"},/area/template_noop)
"EL" = (/obj/machinery/door/firedoor,/obj/effect/window_lwall_spawn/reinforced,/turf/simulated/floor/plating,/area/template_noop)
"Fj" = (/obj/structure/closet/secure_closet/freezer/fridge,/turf/unsimulated/floor{icon_state = "white"},/area/template_noop)
"FS" = (/turf/unsimulated/floor{icon_state = "white"},/area/template_noop)
"Ga" = (/obj/machinery/shower{pixel_y = 32},/obj/item/weapon/soap/deluxe,/obj/structure/curtain/open/shower,/turf/unsimulated/floor{dir = 2; icon_state = "freezerfloor"},/area/template_noop)
"Hn" = (/obj/structure/lattice,/turf/template_noop,/area/template_noop)
"Jp" = (/obj/random/junkfood/rotten,/turf/unsimulated/floor{icon_state = "white"},/area/template_noop)
"Km" = (/obj/structure/girder,/turf/simulated/floor/plating/under,/area/template_noop)
"La" = (/obj/machinery/light{dir = 4},/turf/unsimulated/floor{icon_state = "cult"; name = "plating"},/area/template_noop)
"Mb" = (/obj/structure/table/standard,/obj/item/device/lighting/toggleable/lamp,/turf/unsimulated/floor{icon_state = "lino"},/area/template_noop)
"Nt" = (/obj/structure/sink/kitchen{pixel_y = 26},/turf/unsimulated/floor{icon_state = "white"},/area/template_noop)
"Ou" = (/obj/structure/table/standard,/obj/machinery/reagentgrinder/portable,/turf/unsimulated/floor{icon_state = "white"},/area/template_noop)
"Pa" = (/obj/structure/table/standard,/obj/machinery/chemical_dispenser/soda{pixel_x = 2; pixel_y = 6},/turf/unsimulated/floor{icon_state = "white"},/area/template_noop)
"Pp" = (/obj/machinery/portable_atmospherics/canister/oxygen,/turf/unsimulated/floor{icon_state = "cult"; name = "plating"},/area/template_noop)
"PH" = (/obj/machinery/shower{pixel_y = 32},/obj/structure/curtain/open/shower,/turf/unsimulated/floor{dir = 2; icon_state = "freezerfloor"},/area/template_noop)
"PN" = (/obj/structure/table/standard,/obj/item/weapon/deck/cards,/turf/unsimulated/floor{icon_state = "lino"},/area/template_noop)
"PO" = (/obj/random/junk,/turf/unsimulated/floor{dir = 2; icon_state = "freezerfloor"},/area/template_noop)
"Rh" = (/obj/structure/mirror/antag{pixel_x = -28},/obj/structure/sink{dir = 8; icon_state = "sink"; pixel_x = -12; pixel_y = 2},/turf/unsimulated/floor{dir = 2; icon_state = "freezerfloor"},/area/template_noop)
"RC" = (/obj/random/junk,/obj/machinery/light{dir = 8},/turf/unsimulated/floor{dir = 2; icon_state = "freezerfloor"},/area/template_noop)
"So" = (/obj/structure/urinal{pixel_y = 32},/turf/unsimulated/floor{dir = 2; icon_state = "freezerfloor"},/area/template_noop)
"Sy" = (/obj/machinery/light{dir = 8},/turf/unsimulated/floor{icon_state = "cult"; name = "plating"},/area/template_noop)
"Vq" = (/obj/machinery/light{dir = 4},/turf/simulated/floor/tiled/white/techfloor_grid,/area/template_noop)
"Vt" = (/obj/random/junk,/turf/unsimulated/floor{icon_state = "cult"; name = "plating"},/area/template_noop)
"VJ" = (/turf/unsimulated/floor{icon_state = "lino"},/area/template_noop)
"Wj" = (/obj/random/junk,/turf/unsimulated/floor{icon_state = "white"},/area/template_noop)
"WC" = (/obj/machinery/light_construct{dir = 8},/turf/simulated/floor/plating/under,/area/template_noop)
"WH" = (/obj/structure/table/standard,/obj/item/device/lighting/toggleable/lamp,/turf/unsimulated/floor{icon_state = "cult"; name = "plating"},/area/template_noop)
"Xm" = (/obj/structure/shuttle/engine/propulsion{icon_state = "propulsion_r"},/turf/template_noop,/area/template_noop)
"Xv" = (/obj/random/junk/low_chance,/turf/simulated/floor/plating/under,/area/template_noop)
"Yj" = (/obj/structure/table/standard,/obj/item/weapon/storage/deferred/rations,/obj/machinery/light,/turf/unsimulated/floor{icon_state = "cult"; name = "plating"},/area/template_noop)
"Yp" = (/obj/item/weapon/stool,/obj/random/junkfood/rotten,/turf/unsimulated/floor{icon_state = "lino"},/area/template_noop)
"YW" = (/turf/unsimulated/floor{icon_state = "cult"; name = "plating"},/area/template_noop)
"YZ" = (/turf/simulated/wall/r_wall,/area/template_noop)
"Zt" = (/obj/structure/table/rack,/obj/structure/closet/onestar/tier2/normal,/turf/unsimulated/floor{icon_state = "cult"; name = "plating"},/area/template_noop)
"ZY" = (/mob/living/simple_animal/hostile/bear,/turf/unsimulated/floor{icon_state = "cult"; name = "plating"},/area/template_noop)

(1,1,1) = {"
bibibibibiHnbibibibibiHnHnKmHnbibibibibibibibibibi
bibibiHnbBKmHnawHnbiHnKmbBYZaHHnbibiHnKmbBHnbibibi
bibibiYZEgYZYZYZYZYZYZYZEgYZYZYZYZYZYZYZEgYZbibibi
bibibiYZVtYZaJMbbyDPDPYZYWYZDPBvDPMbcWYZawYZbibibi
bibibiYZYWYZVJVJVJVJVJYZSyYZbBbBbBVJVJKmdNYZbibibi
bibibiELYWYZYpVJVJVJVJEgYWEgHnbibibBeoKmHnHnbibibi
bibibiYZLaYZPNaaVJVJVJYZVtYZbBHnbBaafbKmHnbibibibi
bibibiYZipYZAsiwjsDPrdYZYWYZEoDPjsiweoYZbBHnbibibi
bibibiKmbBYZYZYZYZYZYZKmEgYZYZYZYZYZYZYZbBKmbibibi
bibibiHnbBKmkxnuwRoLqAHnXvbBsgjPssZttvYZYWELbibibi
bibibibiHnEgYWYWYWYWbBHnHnbBYWYWYWabYWEgYWYZbibibi
bibibibiHnKmYWabumwXBzbBHnbBumzgzJYWYWYZSyYZbibibi
bibibiHnawEgYWYWzJzgumbBbBbByJdIumYWYWEgYWYZbibibi
bibibiHnbBYZmZYWumYjyJYWVtYWumzMumCYDiYZZYELbibibi
bibibiKmbBYZYZYZYZYZYZYZEgYZYZYZYZYZYZYZbBKmbibibi
bibibiYZYWYZFjJpNtOuPaYZYWYZSoSoklGaPHYZbBHnbibibi
bibibiYZLaYZlAJpacadFSYZSyYZRCaekWkWVqYZWCKmbibibi
bibibiELYWYZBQtKWjacacwUYWEglOaeqaduduYZYWELbibibi
bibiYZYZEgYZrLxNxNFSegYZVtYZRhPOYZYZYZYZEgYZYZbibi
biYZYZqLYWYZkOfMiYvzaKYZbBKmbBlOqXbGBqYZYWqLYZYZbi
biYZEesNoXYZYZYZYZYZYZKmHnbBKmYZYZYZYZYZdUsNwXYZbi
biYZWHYWabPpvtYZYZbiHnHnbiHnHnbiYZYZvtPpabYWWHYZbi
biYZrururururuYZHnHnHnbibibiHnHnHnYZrururururuYZbi
bibigNzTgNzTXmbibibibibibibibibibibigNzTgNzTXmbibi
bibibibibibibibibibibibibibibibibibibibibibibibibi
"}
