"a" = (/turf/simulated/wall,/area/crawler)
"b" = (/obj/crawler/crawler_wallbreaker,/turf/simulated/wall,/area/crawler)
"c" = (/turf/simulated/floor/tiled/derelict,/area/crawler)
"d" = (/turf/simulated/floor/carpet,/area/crawler)
"e" = (/obj/crawler/crawler_wallbreaker/vertical,/turf/simulated/wall,/area/crawler)
"f" = (/obj/rogue/telebeacon,/turf/simulated/floor/carpet,/area/crawler)
"g" = (/obj/random/structures/os,/turf/simulated/floor/tiled/derelict,/area/crawler)
"h" = (/obj/structure/closet/onestar/tier3/special,/obj/random/credits/c1000,/turf/simulated/floor/tiled/derelict,/area/crawler)
"i" = (/mob/living/simple_animal/hostile/megafauna/one_star,/turf/simulated/floor/tiled/derelict,/area/crawler)
"j" = (/obj/structure/table/onestar,/obj/random/dungeon_ammo,/obj/random/dungeon_ammo,/obj/random/dungeon_gun_energy,/turf/simulated/floor/tiled/derelict,/area/crawler)
"k" = (/obj/structure/table/onestar,/obj/item/weapon/gun/energy/captain,/obj/random/dungeon_ammo,/obj/random/dungeon_ammo,/obj/random/dungeon_gun_energy,/obj/random/material_rare,/turf/simulated/floor/tiled/derelict,/area/crawler)
"l" = (/obj/structure/table/onestar,/obj/random/dungeon_gun_energy,/obj/random/material_rare,/turf/simulated/floor/tiled/derelict,/area/crawler)
"m" = (/obj/machinery/light,/obj/structure/closet/onestar/tier3/special,/obj/random/credits/c1000,/turf/simulated/floor/tiled/derelict,/area/crawler)
"n" = (/obj/structure/table/onestar,/obj/random/dungeon_gun_ballistic,/obj/random/dungeon_gun_ballistic,/obj/random/dungeon_gun_energy,/obj/random/material_rare,/turf/simulated/floor/tiled/derelict,/area/crawler)
"o" = (/obj/structure/table/onestar,/obj/random/dungeon_gun_ballistic,/obj/random/dungeon_gun_ballistic,/obj/random/material_rare,/obj/random/material_resources,/turf/simulated/floor/tiled/derelict,/area/crawler)
"p" = (/obj/structure/table/onestar,/obj/random/dungeon_gun_ballistic,/obj/random/material_resources,/turf/simulated/floor/tiled/derelict,/area/crawler)

(1,1,1) = {"
aaaaaabaaaaaa
agghhcichhgga
accccdddcccca
accccdcccccca
eccccdfdcccce
accccdcccccca
accccdddcccca
aghjklmnophga
aaaaaabaaaaaa
"}
