"aa" = (/turf/template_noop,/area/template_noop)
"ab" = (/obj/structure/lattice,/turf/template_noop,/area/template_noop)
"ac" = (/turf/simulated/floor/plating/under,/area/template_noop)
"ad" = (/obj/structure/girder,/turf/simulated/floor/plating/under,/area/template_noop)
"ae" = (/turf/simulated/floor/tiled/derelict/white_small_edges,/area/template_noop)
"af" = (/turf/simulated/floor/tiled/derelict/white_big_edges,/area/template_noop)
"ag" = (/turf/simulated/wall/untinted/onestar_reinforced,/area/template_noop)
"ah" = (/obj/random/junk,/obj/structure/sign/faction/derelict2{pixel_y = 32},/turf/simulated/floor/tiled/derelict/white_small_edges,/area/template_noop)
"ai" = (/obj/random/scrap/dense_weighted,/turf/simulated/floor/plating/under,/area/template_noop)
"aj" = (/obj/machinery/door/airlock/sandstone{name = "OneStar Airlock"},/turf/simulated/floor/tiled/derelict,/area/template_noop)
"ak" = (/obj/machinery/optable,/obj/random/prothesis/one_star,/turf/simulated/floor/tiled/derelict/white_big_edges,/area/template_noop)
"al" = (/obj/machinery/bodyscanner,/turf/simulated/floor/tiled/derelict/white_small_edges,/area/template_noop)
"am" = (/obj/machinery/body_scanconsole,/turf/simulated/floor/tiled/derelict/white_small_edges,/area/template_noop)
"an" = (/obj/structure/bed/chair/custom/onestar{dir = 8},/turf/simulated/floor/tiled/derelict/white_small_edges,/area/template_noop)
"ao" = (/turf/simulated/floor/tiled/derelict,/area/template_noop)
"ap" = (/obj/structure/table/onestar,/obj/random/prothesis/one_star,/turf/simulated/floor/tiled/derelict/white_small_edges,/area/template_noop)
"aq" = (/obj/structure/bed/chair/custom/onestar/red,/turf/simulated/floor/tiled/derelict/white_small_edges,/area/template_noop)
"ar" = (/obj/structure/salvageable/implant_container,/turf/simulated/floor/tiled/derelict/white_small_edges,/area/template_noop)
"as" = (/obj/structure/table/onestar,/obj/structure/window/basic,/turf/simulated/floor/tiled/derelict/white_small_edges,/area/template_noop)
"at" = (/obj/structure/table/onestar,/obj/machinery/door/window/southright,/turf/simulated/floor/tiled/derelict/white_small_edges,/area/template_noop)
"au" = (/obj/structure/railing,/turf/template_noop,/area/template_noop)
"av" = (/mob/living/carbon/superior_animal/robot/greyson/roomba/gun_ba,/turf/simulated/floor/tiled/derelict,/area/template_noop)
"aw" = (/obj/structure/catwalk,/turf/template_noop,/area/template_noop)
"ax" = (/obj/structure/catwalk,/obj/machinery/door/airlock/external,/turf/template_noop,/area/template_noop)
"ay" = (/obj/structure/railing{dir = 1},/turf/template_noop,/area/template_noop)
"az" = (/obj/machinery/light/floor,/turf/simulated/floor/tiled/derelict/white_small_edges,/area/template_noop)
"aA" = (/mob/living/carbon/superior_animal/robot/greyson/roomba/slayer,/turf/simulated/floor/tiled/derelict/white_big_edges,/area/template_noop)
"aB" = (/obj/structure/sign/faction/derelict2,/turf/simulated/wall/untinted/onestar_reinforced,/area/template_noop)
"aC" = (/obj/machinery/vending/cola,/turf/simulated/floor/tiled/derelict,/area/template_noop)
"aD" = (/obj/machinery/vending/coffee,/turf/simulated/floor/tiled/derelict/white_small_edges,/area/template_noop)
"aE" = (/mob/living/carbon/superior_animal/robot/greyson/synthetic,/turf/simulated/floor/tiled/derelict,/area/template_noop)
"aF" = (/obj/structure/reagent_dispensers/water_cooler,/turf/simulated/floor/tiled/derelict,/area/template_noop)
"aG" = (/turf/simulated/wall/untinted/onestar,/area/template_noop)
"aH" = (/mob/living/carbon/superior_animal/robot/greyson/roomba/boomba,/turf/simulated/floor/tiled/derelict/white_big_edges,/area/template_noop)
"aI" = (/obj/structure/window/basic,/turf/simulated/floor/tiled/derelict/white_big_edges,/area/template_noop)
"aJ" = (/obj/structure/window/basic,/obj/structure/bed/chair/custom/onestar/red,/turf/simulated/floor/tiled/derelict/white_big_edges,/area/template_noop)
"aK" = (/obj/structure/closet/onestar/tier1/medical,/obj/item/weapon/reagent_containers/blood/empty,/turf/simulated/floor/tiled/derelict/white_big_edges,/area/template_noop)
"aL" = (/obj/structure/closet/onestar/tier1/medical,/turf/simulated/floor/tiled/derelict/white_big_edges,/area/template_noop)
"aM" = (/obj/structure/sink{dir = 8; icon_state = "sink"; pixel_x = -12; pixel_y = 2},/turf/simulated/floor/tiled/derelict/white_big_edges,/area/template_noop)
"aN" = (/obj/structure/medical_stand,/turf/simulated/floor/tiled/derelict/white_big_edges,/area/template_noop)
"aO" = (/obj/structure/table/onestar,/obj/random/surgery_tool,/obj/random/surgery_tool,/obj/random/surgery_tool,/obj/random/techpart/low_chance,/obj/item/weapon/reagent_containers/blood/OMinus,/turf/simulated/floor/tiled/derelict/white_big_edges,/area/template_noop)
"aP" = (/obj/random/junk,/turf/simulated/floor/tiled/derelict/white_small_edges,/area/template_noop)
"aQ" = (/obj/item/weapon/reagent_containers/food/drinks/drinkingglass/soda,/obj/item/weapon/reagent_containers/food/drinks/drinkingglass/soda,/turf/simulated/floor/tiled/derelict,/area/template_noop)
"aR" = (/obj/machinery/vending/cigarette,/turf/simulated/floor/tiled/derelict/white_small_edges,/area/template_noop)
"aS" = (/obj/structure/sign/departmentold/examroom,/turf/simulated/wall/untinted/onestar,/area/template_noop)
"aT" = (/obj/structure/sign/directions/evac{dir = 8; icon_state = "direction_evac"},/turf/simulated/wall/untinted/onestar,/area/template_noop)
"aU" = (/obj/random/scrap/sparse_even,/turf/simulated/floor/tiled/derelict/white_big_edges,/area/template_noop)
"aV" = (/mob/living/carbon/superior_animal/robot/greyson/synthetic,/turf/simulated/floor/tiled/derelict/white_big_edges,/area/template_noop)
"aW" = (/obj/structure/noticeboard,/turf/simulated/wall/untinted/onestar,/area/template_noop)
"aX" = (/obj/random/junk,/turf/simulated/floor/tiled/derelict,/area/template_noop)
"aY" = (/obj/random/techpart/low_chance,/turf/simulated/floor/tiled/derelict,/area/template_noop)
"aZ" = (/obj/random/junk,/turf/simulated/floor/tiled/derelict/white_big_edges,/area/template_noop)
"ba" = (/obj/random/techpart/low_chance,/obj/random/techpart/low_chance,/obj/random/techpart/low_chance,/turf/simulated/floor/tiled/derelict/white_big_edges,/area/template_noop)
"bb" = (/obj/item/weapon/reagent_containers/blood/OMinus,/obj/random/techpart/low_chance,/turf/simulated/floor/tiled/derelict/white_big_edges,/area/template_noop)
"bc" = (/obj/random/junk,/turf/simulated/floor/plating/under,/area/template_noop)
"bd" = (/obj/random/techpart/low_chance,/turf/simulated/floor/plating/under,/area/template_noop)
"be" = (/obj/item/weapon/reagent_containers/blood/OMinus,/obj/random/techpart/low_chance,/obj/random/junk,/turf/simulated/floor/tiled/derelict/white_big_edges,/area/template_noop)
"bf" = (/obj/structure/table/onestar,/obj/random/surgery_tool,/obj/random/surgery_tool,/obj/random/surgery_tool,/obj/random/surgery_tool,/obj/random/techpart/low_chance,/obj/item/weapon/reagent_containers/blood/OMinus,/obj/random/medical,/turf/simulated/floor/tiled/derelict/white_big_edges,/area/template_noop)
"bg" = (/obj/structure/table/onestar,/obj/item/weapon/tool/screwdriver/combi_driver/onestar,/obj/item/weapon/tool/crowbar/onestar,/obj/random/medical,/turf/simulated/floor/tiled/derelict/white_big_edges,/area/template_noop)
"bh" = (/obj/random/junk,/obj/random/junk,/obj/random/junk,/obj/random/junk,/turf/simulated/floor/plating/under,/area/template_noop)
"bi" = (/obj/item/bodybag,/obj/item/weapon/reagent_containers/glass/bottle/antitoxin{pixel_x = -4; pixel_y = 8},/obj/item/weapon/reagent_containers/glass/bottle/inaprovaline{pixel_x = 4; pixel_y = 7},/obj/item/weapon/reagent_containers/syringe,/obj/item/weapon/reagent_containers/syringe/spaceacillin,/obj/item/weapon/reagent_containers/syringe/spaceacillin,/obj/structure/table/onestar,/obj/random/medical,/turf/simulated/floor/tiled/derelict/white_small_edges,/area/template_noop)
"bj" = (/obj/item/roller{pixel_y = 8},/obj/item/weapon/reagent_containers/blood/OMinus,/obj/item/weapon/reagent_containers/blood/OMinus,/obj/item/weapon/reagent_containers/syringe/spaceacillin,/obj/structure/table/onestar,/obj/random/medical,/turf/simulated/floor/tiled/derelict/white_small_edges,/area/template_noop)
"bk" = (/obj/random/junkfood,/turf/simulated/floor/tiled/derelict/white_small_edges,/area/template_noop)
"bl" = (/obj/random/techpart/low_chance,/turf/simulated/floor/tiled/derelict/white_small_edges,/area/template_noop)
"bm" = (/obj/random/junkfood,/turf/simulated/floor/plating/under,/area/template_noop)
"bn" = (/obj/structure/lattice,/turf/simulated/floor/plating/under,/area/template_noop)
"bo" = (/obj/random/junk,/obj/random/junk,/turf/simulated/floor/plating/under,/area/template_noop)
"bp" = (/obj/structure/railing,/obj/structure/lattice,/turf/template_noop,/area/template_noop)
"bq" = (/obj/item/weapon/reagent_containers/food/drinks/drinkingglass/soda,/turf/simulated/floor/tiled/derelict,/area/template_noop)
"br" = (/obj/random/junkfood,/turf/simulated/floor/tiled/derelict,/area/template_noop)
"bs" = (/obj/structure/railing{dir = 1},/obj/structure/lattice,/turf/template_noop,/area/template_noop)
"bt" = (/mob/living/carbon/superior_animal/robot/greyson/synthetic/epistol,/turf/simulated/floor/tiled/derelict/white_small_edges,/area/template_noop)
"bu" = (/mob/living/carbon/superior_animal/robot/greyson/synthetic/epistol/esmg,/turf/simulated/floor/tiled/derelict/white_small_edges,/area/template_noop)
"bv" = (/obj/structure/catwalk,/mob/living/carbon/superior_animal/robot/greyson/synthetic,/turf/template_noop,/area/template_noop)
"bw" = (/mob/living/carbon/superior_animal/robot/greyson/synthetic,/turf/simulated/floor/tiled/derelict/white_small_edges,/area/template_noop)
"bK" = (/obj/random/scrap/sparse_even,/turf/simulated/floor/plating/under,/area/template_noop)
"rh" = (/obj/random/junk,/obj/structure/sign/faction/one_star_old{pixel_y = 32},/turf/simulated/floor/tiled/derelict,/area/template_noop)
"uc" = (/mob/living/carbon/superior_animal/robot/greyson/roomba/gun_ba,/turf/simulated/floor/tiled/derelict/white_small_edges,/area/template_noop)
"EA" = (/mob/living/carbon/superior_animal/robot/greyson/roomba/slayer,/turf/simulated/floor/tiled/derelict,/area/template_noop)
"Lk" = (/obj/structure/sign/faction/derelict1{pixel_y = 32},/turf/simulated/floor/tiled/derelict,/area/template_noop)

(1,1,1) = {"
aaaaaaaaabaaaaaaaaaaaaababaaaaaaaaabababababababaa
aaaaaaababaaaaababababaaababaaabacabacacacabababab
aaaaaaacbKacacacacacacacacacacacacacacadacacbKadac
aaaaaaagagagajagagagajagagagajagagacacagagagagagab
aaaaaaagaPaoaeaeaeaeaoaPaPaeaoaeahaoaoacacacaiadab
aaaaaaagaCaQaXaEavaoaoaoaoaYaoaEaoaYaoacacacababaa
aaaaaaagaDaQaeaeaeaeaoaPaeaPaoaeaPaoaoacacacacabab
aaaaaaagagagajagagagajagagagajagagaoaoagagagagacab
aaaaaaagafaVafaVagafaVafagaZafbaagaoaoagbbbcacbdaa
aaabaaagaAaIaJaJagafaIaJagaKaHaLagaoaoagbebcababaa
aaababagaMafafaNagaMafaNagaLaVaLagaoaoagaVacabacaa
aaaaabagaObfafakagbgafakagaLafaLagaoaoagaUacbcacaa
aaababagagagagagagagagagagagagagagaoaoaBagagagabaa
aaababadbKacacbhagbibjapaealamanaGaoaYbkbkaRagadaa
aaaaabadacacacbhagaPaeaeaeaeaeaeaSEAaoblbkbkbKbmaa
aaaaaabnacacacboagaebtaeucaeaPbtajaoaoaeaeaeadaaaa
aaaaaaabacacacaiagaeaPaqaqaeaearaGaoaoaebuaeagabaa
aaaaadadadadagagaTaGaGasasataGaWaGaoaXaeaeaeadabaa
aaaaabaubpauauagaoLkrhaoaoaoaFbqaCaoaoaeaeaeagabaa
aaaaabawbvawawaxaoaoaoaoaoaoaoaobraoaoaeaeblagaaaa
aaaaabaybsayayagaoaoaoEAaoaoaoaoaoaoaYaeaeaeagaaaa
ababacadadadagagaeaPaeaeaPaeaeaeblaeaeaebwaeagaaaa
abaaacbKacabacadblaeazaeaeacbdadacadadadadadagabab
aaaaacacabaaabadadadadadadadababababaaabaaaaabaaaa
aaaaababaaaaabaaaaababaaababaaaaaaaaaaababaaabaaaa
"}
