//MAP CONVERTED BY dmm2tgm.py THIS HEADER COMMENT PREVENTS RECONVERSION, DO NOT REMOVE
"a" = (
/turf/simulated/wall/untinted/onestar_reinforced,
/area/crawler)
"b" = (
/turf/simulated/floor/tiled/derelict/red_white_edges,
/area/crawler)
"c" = (
/obj/effect/floor_decal/industrial/outline,
/obj/structure/closet/onestar/tier3,
/turf/simulated/floor/tiled/dark/brown_perforated,
/area/crawler)
"e" = (
/obj/effect/floor_decal/industrial/warning{
	dir = 8
	},
/turf/simulated/floor/tiled/derelict/red_white_edges,
/area/crawler)
"f" = (
/turf/simulated/floor/tiled/dark/brown_platform,
/area/crawler)
"g" = (
/obj/machinery/door/airlock/vault/bolted,
/turf/simulated/floor/tiled/dark/gray_perforated,
/area/crawler)
"h" = (
/obj/effect/floor_decal/industrial/warning{
	dir = 4
	},
/turf/simulated/floor/tiled/derelict/red_white_edges,
/area/crawler)
"j" = (
/obj/crawler/crawler_wallbreaker/vertical,
/turf/simulated/wall/untinted/onestar_reinforced,
/area/crawler)
"k" = (
/obj/structure/table/onestar,
/obj/random/junkfood/low_chance,
/obj/random/junkfood/low_chance,
/obj/random/junkfood/low_chance,
/obj/random/junkfood/rotten,
/obj/random/junkfood/rotten,
/turf/simulated/floor/tiled/dark/brown_perforated,
/area/crawler)
"l" = (
/obj/structure/table/onestar,
/obj/random/junkfood/low_chance,
/obj/random/junkfood/low_chance,
/obj/random/junkfood/low_chance,
/obj/random/junkfood/low_chance,
/obj/random/junkfood/low_chance,
/obj/random/junkfood/rotten,
/obj/random/junkfood/rotten,
/turf/simulated/floor/tiled/dark/brown_perforated,
/area/crawler)
"m" = (
/turf/simulated/floor/tiled/dark/gray_perforated,
/area/crawler)
"o" = (
/obj/random/mob/roomba,
/turf/simulated/floor/tiled/derelict/red_white_edges,
/area/crawler)
"q" = (
/obj/machinery/door/airlock/vault/bolted,
/turf/simulated/floor/tiled/dark/brown_platform,
/area/crawler)
"s" = (
/obj/crawler/crawler_wallbreaker,
/turf/simulated/wall/untinted/onestar_reinforced,
/area/crawler)
"t" = (
/obj/structure/sign/faction/one_star,
/turf/simulated/wall/untinted/onestar_reinforced,
/area/crawler)
"u" = (
/obj/effect/floor_decal/industrial/outline,
/obj/structure/closet/onestar/tier2,
/turf/simulated/floor/tiled/dark/brown_perforated,
/area/crawler)
"w" = (
/obj/structure/table/onestar,
/obj/random/junkfood/low_chance,
/obj/random/junkfood/low_chance,
/obj/random/junkfood/low_chance,
/obj/random/junkfood/rotten,
/turf/simulated/floor/tiled/dark/brown_perforated,
/area/crawler)
"x" = (
/obj/structure/table/onestar,
/obj/random/gun_energy_cheap/low_chance,
/obj/random/junkfood/low_chance,
/obj/random/junkfood/low_chance,
/obj/random/junkfood/rotten,
/obj/random/junkfood/rotten,
/turf/simulated/floor/tiled/dark/brown_perforated,
/area/crawler)
"y" = (
/obj/structure/table/rack,
/obj/random/gun_normal,
/obj/random/gun_energy_cheap/low_chance,
/obj/random/gun_combat/low_chance,
/obj/random/gun_combat/low_chance,
/obj/random/ammo/low_chance,
/obj/random/ammo/low_chance,
/obj/random/ammo/shotgun/low_chance,
/obj/random/ammo/shotgun/low_chance,
/obj/random/ammo_fancy/low_chance,
/obj/random/ammo_fancy/low_chance,
/obj/random/ammo_lowcost/low_chance,
/obj/random/ammo_lowcost/low_chance,
/obj/random/dungeon_gun_ballistic/low_chance,
/obj/random/dungeon_gun_ballistic/low_chance,
/obj/random/dungeon_gun_energy/low_chance,
/obj/random/dungeon_gun_energy/low_chance,
/obj/random/dungeon_ammo,
/obj/random/dungeon_ammo,
/obj/random/dungeon_gun_energy,
/obj/random/dungeon_gun_mods,
/obj/random/dungeon_gun_mods/low_chance,
/turf/simulated/floor/tiled/dark/brown_perforated,
/area/crawler)
"z" = (
/obj/structure/table/onestar,
/obj/random/junkfood/low_chance,
/obj/random/junkfood/low_chance,
/obj/random/junkfood/rotten,
/obj/random/junkfood/rotten,
/turf/simulated/floor/tiled/dark/brown_perforated,
/area/crawler)
"A" = (
/obj/structure/table/onestar,
/obj/random/junkfood/low_chance,
/obj/random/junkfood/rotten,
/turf/simulated/floor/tiled/dark/brown_perforated,
/area/crawler)
"B" = (
/obj/structure/table/rack,
/obj/random/gun_shotgun,
/obj/random/gun_shotgun/low_chance,
/obj/random/gun_energy_cheap/low_chance,
/obj/random/gun_energy_cheap/low_chance,
/obj/random/gun_combat/low_chance,
/obj/random/gun_combat/low_chance,
/obj/random/ammo/low_chance,
/obj/random/ammo/low_chance,
/obj/random/ammo/shotgun/low_chance,
/obj/random/ammo/shotgun/low_chance,
/obj/random/ammo_fancy/low_chance,
/obj/random/ammo_fancy/low_chance,
/obj/random/ammo_lowcost/low_chance,
/obj/random/ammo_lowcost/low_chance,
/obj/random/dungeon_gun_ballistic/low_chance,
/obj/random/dungeon_gun_ballistic/low_chance,
/obj/random/dungeon_gun_energy/low_chance,
/obj/random/dungeon_gun_energy/low_chance,
/obj/random/dungeon_ammo,
/obj/random/dungeon_ammo,
/obj/random/dungeon_gun_energy,
/obj/random/dungeon_gun_mods,
/obj/random/dungeon_gun_mods/low_chance,
/turf/simulated/floor/tiled/dark/brown_perforated,
/area/crawler)
"C" = (
/obj/structure/table/rack,
/obj/random/gun_shotgun/low_chance,
/obj/random/gun_normal/low_chance,
/obj/random/gun_energy_cheap/low_chance,
/obj/random/gun_energy_cheap/low_chance,
/obj/random/gun_combat/low_chance,
/obj/random/ammo/low_chance,
/obj/random/ammo/low_chance,
/obj/random/ammo/shotgun/low_chance,
/obj/random/ammo/shotgun/low_chance,
/obj/random/ammo_fancy/low_chance,
/obj/random/ammo_fancy/low_chance,
/obj/random/ammo_fancy/low_chance,
/obj/random/ammo_lowcost/low_chance,
/obj/random/ammo_lowcost/low_chance,
/obj/random/dungeon_gun_ballistic/low_chance,
/obj/random/dungeon_gun_ballistic/low_chance,
/obj/random/dungeon_gun_energy/low_chance,
/obj/random/dungeon_gun_energy/low_chance,
/obj/random/dungeon_ammo,
/obj/random/dungeon_ammo,
/obj/random/dungeon_gun_energy,
/obj/random/dungeon_gun_mods/low_chance,
/turf/simulated/floor/tiled/dark/brown_perforated,
/area/crawler)
"D" = (
/obj/structure/table/rack,
/obj/random/gun_shotgun/low_chance,
/obj/random/gun_normal/low_chance,
/obj/random/gun_energy_cheap/low_chance,
/obj/random/gun_combat/low_chance,
/obj/random/ammo/low_chance,
/obj/random/ammo/low_chance,
/obj/random/ammo/shotgun/low_chance,
/obj/random/ammo/shotgun/low_chance,
/obj/random/ammo_fancy/low_chance,
/obj/random/ammo_fancy/low_chance,
/obj/random/ammo_fancy/low_chance,
/obj/random/ammo_fancy/low_chance,
/obj/random/ammo_lowcost/low_chance,
/obj/random/ammo_lowcost/low_chance,
/obj/random/dungeon_gun_ballistic/low_chance,
/obj/random/dungeon_gun_ballistic/low_chance,
/obj/random/dungeon_gun_energy/low_chance,
/obj/random/dungeon_gun_energy/low_chance,
/obj/random/dungeon_ammo,
/obj/random/dungeon_ammo,
/obj/random/dungeon_gun_energy,
/obj/random/dungeon_gun_mods,
/obj/random/dungeon_gun_mods/low_chance,
/turf/simulated/floor/tiled/dark/brown_perforated,
/area/crawler)
"E" = (
/obj/structure/table/rack,
/obj/random/gun_normal,
/obj/random/gun_energy_cheap/low_chance,
/obj/random/gun_energy_cheap/low_chance,
/obj/random/gun_combat/low_chance,
/obj/random/gun_combat/low_chance,
/obj/random/ammo/low_chance,
/obj/random/ammo/low_chance,
/obj/random/ammo/shotgun/low_chance,
/obj/random/ammo/shotgun/low_chance,
/obj/random/ammo_fancy/low_chance,
/obj/random/ammo_fancy/low_chance,
/obj/random/ammo_lowcost/low_chance,
/obj/random/ammo_lowcost/low_chance,
/obj/random/dungeon_gun_ballistic/low_chance,
/obj/random/dungeon_gun_ballistic/low_chance,
/obj/random/dungeon_gun_energy/low_chance,
/obj/random/dungeon_gun_energy/low_chance,
/obj/random/dungeon_ammo,
/obj/random/dungeon_ammo,
/obj/random/dungeon_gun_ballistic,
/obj/random/dungeon_gun_mods/low_chance,
/turf/simulated/floor/tiled/dark/brown_perforated,
/area/crawler)
"F" = (
/obj/structure/table/rack,
/obj/random/gun_shotgun,
/obj/random/gun_energy_cheap/low_chance,
/obj/random/gun_energy_cheap/low_chance,
/obj/random/gun_energy_cheap/low_chance,
/obj/random/gun_combat/low_chance,
/obj/random/gun_combat/low_chance,
/obj/random/ammo/low_chance,
/obj/random/ammo/low_chance,
/obj/random/ammo/shotgun/low_chance,
/obj/random/ammo/shotgun/low_chance,
/obj/random/ammo_fancy/low_chance,
/obj/random/ammo_fancy/low_chance,
/obj/random/ammo_lowcost/low_chance,
/obj/random/ammo_lowcost/low_chance,
/obj/random/dungeon_gun_ballistic/low_chance,
/obj/random/dungeon_gun_ballistic/low_chance,
/obj/random/dungeon_gun_energy/low_chance,
/obj/random/dungeon_gun_energy/low_chance,
/obj/random/dungeon_ammo,
/obj/random/dungeon_ammo,
/obj/random/dungeon_gun_ballistic,
/obj/random/dungeon_gun_mods/low_chance,
/turf/simulated/floor/tiled/dark/brown_perforated,
/area/crawler)
"G" = (
/obj/structure/table/onestar,
/obj/random/ammo_lowcost/low_chance,
/obj/random/ammo_lowcost/low_chance,
/obj/random/ammo_lowcost/low_chance,
/obj/random/ammo/shotgun/low_chance,
/obj/random/ammo/shotgun/low_chance,
/obj/random/powercell/low_chance,
/obj/random/powercell/low_chance,
/obj/random/powercell/low_chance,
/turf/simulated/floor/tiled/dark/brown_perforated,
/area/crawler)
"H" = (
/obj/structure/table/onestar,
/obj/random/ammo_lowcost/low_chance,
/obj/random/ammo_lowcost/low_chance,
/obj/random/ammo_lowcost/low_chance,
/obj/random/ammo/shotgun/low_chance,
/obj/random/powercell/low_chance,
/obj/random/powercell/low_chance,
/obj/random/powercell/low_chance,
/turf/simulated/floor/tiled/dark/brown_perforated,
/area/crawler)
"I" = (
/obj/structure/table/onestar,
/obj/random/ammo/low_chance,
/obj/random/ammo/low_chance,
/obj/random/ammo/low_chance,
/obj/random/ammo/shotgun/low_chance,
/obj/random/powercell/low_chance,
/obj/random/powercell/low_chance,
/obj/random/powercell/low_chance,
/turf/simulated/floor/tiled/dark/brown_perforated,
/area/crawler)
"J" = (
/obj/structure/table/rack,
/obj/random/gun_shotgun/low_chance,
/obj/random/gun_energy_cheap/low_chance,
/obj/random/gun_energy_cheap/low_chance,
/obj/random/gun_energy_cheap/low_chance,
/obj/random/gun_combat/low_chance,
/obj/random/gun_combat/low_chance,
/obj/random/ammo/low_chance,
/obj/random/ammo/low_chance,
/obj/random/ammo/shotgun/low_chance,
/obj/random/ammo/shotgun/low_chance,
/obj/random/ammo_fancy/low_chance,
/obj/random/ammo_fancy/low_chance,
/obj/random/ammo_lowcost/low_chance,
/obj/random/ammo_lowcost/low_chance,
/obj/random/dungeon_gun_ballistic/low_chance,
/obj/random/dungeon_gun_ballistic/low_chance,
/obj/random/dungeon_gun_energy/low_chance,
/obj/random/dungeon_gun_energy/low_chance,
/obj/random/dungeon_ammo,
/obj/random/dungeon_ammo,
/obj/random/dungeon_gun_ballistic,
/obj/random/dungeon_gun_mods,
/obj/random/dungeon_gun_mods/low_chance,
/turf/simulated/floor/tiled/dark/brown_perforated,
/area/crawler)
"K" = (
/obj/structure/table/rack,
/obj/random/gun_shotgun/low_chance,
/obj/random/gun_normal/low_chance,
/obj/random/gun_energy_cheap/low_chance,
/obj/random/gun_energy_cheap/low_chance,
/obj/random/gun_combat/low_chance,
/obj/random/gun_combat/low_chance,
/obj/random/ammo/low_chance,
/obj/random/ammo/low_chance,
/obj/random/ammo/shotgun/low_chance,
/obj/random/ammo/shotgun/low_chance,
/obj/random/ammo_fancy/low_chance,
/obj/random/ammo_fancy/low_chance,
/obj/random/ammo_lowcost/low_chance,
/obj/random/ammo_lowcost/low_chance,
/obj/random/dungeon_gun_ballistic/low_chance,
/obj/random/dungeon_gun_ballistic/low_chance,
/obj/random/dungeon_gun_energy/low_chance,
/obj/random/dungeon_gun_energy/low_chance,
/obj/random/dungeon_ammo,
/obj/random/dungeon_ammo,
/obj/random/dungeon_gun_ballistic,
/obj/random/dungeon_gun_mods/low_chance,
/turf/simulated/floor/tiled/dark/brown_perforated,
/area/crawler)
"O" = (
/obj/random/structures/os,
/turf/simulated/floor/tiled/dark/gray_perforated,
/area/crawler)
"V" = (
/obj/random/structures/os,
/turf/simulated/floor/tiled/derelict/red_white_edges,
/area/crawler)

(1,1,1) = {"
a
a
a
a
a
j
a
a
a
"}
(2,1,1) = {"
a
c
f
k
a
y
f
E
a
"}
(3,1,1) = {"
a
c
f
l
a
B
f
F
a
"}
(4,1,1) = {"
a
u
f
w
a
a
q
a
a
"}
(5,1,1) = {"
a
a
g
a
t
O
m
G
s
"}
(6,1,1) = {"
s
b
o
o
b
e
e
H
s
"}
(7,1,1) = {"
s
t
o
o
V
t
b
a
s
"}
(8,1,1) = {"
s
b
o
o
b
h
h
I
s
"}
(9,1,1) = {"
a
a
g
a
t
O
m
I
s
"}
(10,1,1) = {"
a
u
f
x
a
a
q
a
a
"}
(11,1,1) = {"
a
u
f
z
a
C
f
J
a
"}
(12,1,1) = {"
a
c
f
A
a
D
f
K
a
"}
(13,1,1) = {"
a
a
j
j
j
j
j
a
a
"}
