//MAP CONVERTED BY dmm2tgm.py THIS HEADER COMMENT PREVENTS RECONVERSION, DO NOT REMOVE
"a" = (
/turf/simulated/wall/untinted/onestar_reinforced,
/area/crawler)
"b" = (
/obj/crawler/crawler_wallbreaker,
/turf/simulated/wall/untinted/onestar_reinforced,
/area/crawler)
"c" = (
/turf/simulated/floor/wood,
/area/crawler)
"e" = (
/obj/structure/filingcabinet,
/turf/simulated/floor/wood,
/area/crawler)
"f" = (
/obj/structure/undies_wardrobe,
/turf/simulated/floor/wood,
/area/crawler)
"g" = (
/obj/structure/bed,
/obj/item/bedsheet/brown,
/turf/simulated/floor/wood,
/area/crawler)
"h" = (
/obj/effect/window_lwall_spawn/smartspawn/onestar,
/turf/simulated/floor/tiled/techmaint,
/area/crawler)
"i" = (
/obj/crawler/crawler_wallbreaker,
/obj/machinery/status_display,
/turf/simulated/wall/untinted/onestar_reinforced,
/area/crawler)
"j" = (
/turf/simulated/floor/carpet/bcarpet,
/area/crawler)
"k" = (
/obj/structure/table/onestar,
/turf/simulated/floor/carpet/bcarpet,
/area/crawler)
"l" = (
/obj/random/turret/os,
/turf/simulated/floor/tiled/techmaint,
/area/crawler)
"m" = (
/turf/simulated/floor/tiled/derelict,
/area/crawler)
"n" = (
/obj/random/mob/roomba,
/turf/simulated/floor/wood,
/area/crawler)
"p" = (
/turf/simulated/floor/tiled/cafe,
/area/crawler)
"q" = (
/obj/structure/table/rack,
/obj/structure/window/reinforced{
	dir = 4
	},
/obj/structure/window/reinforced{
	dir = 8
	},
/obj/random/booze,
/obj/random/booze,
/turf/simulated/floor/wood,
/area/crawler)
"r" = (
/obj/structure/table/rack,
/obj/structure/window/reinforced{
	dir = 8
	},
/obj/structure/window/reinforced{
	dir = 4
	},
/obj/random/ammo_fancy,
/obj/random/ammo_fancy,
/turf/simulated/floor/wood,
/area/crawler)
"s" = (
/obj/structure/closet/onestar/tier3,
/turf/simulated/floor/wood,
/area/crawler)
"t" = (
/obj/machinery/door/airlock/centcom,
/turf/simulated/floor/tiled/techmaint,
/area/crawler)
"u" = (
/obj/machinery/door/airlock/centcom,
/turf/simulated/floor/tiled/derelict,
/area/crawler)
"v" = (
/obj/machinery/door/airlock/centcom,
/turf/simulated/floor/wood,
/area/crawler)
"x" = (
/obj/crawler/crawler_wallbreaker/vertical,
/turf/simulated/wall/untinted/onestar_reinforced,
/area/crawler)
"y" = (
/obj/structure/table/onestar,
/obj/item/device/lighting/toggleable/lamp/green,
/obj/random/booze,
/turf/simulated/floor/wood,
/area/crawler)
"z" = (
/obj/structure/low_wall/onestar,
/turf/simulated/floor/tiled/techmaint,
/area/crawler)
"A" = (
/obj/structure/table/onestar,
/obj/random/structures/os,
/turf/simulated/floor/wood,
/area/crawler)
"B" = (
/obj/structure/bed/chair/office/dark{
	dir = 8
	},
/turf/simulated/floor/wood,
/area/crawler)
"C" = (
/obj/structure/table/onestar,
/obj/machinery/button{
	id = 2;
	name = "Shutters"
	},
/turf/simulated/floor/carpet/bcarpet,
/area/crawler)
"D" = (
/obj/structure/bed/chair/office/dark{
	dir = 8
	},
/turf/simulated/floor/carpet/bcarpet,
/area/crawler)
"E" = (
/obj/structure/bed/chair/office/dark{
	dir = 4
	},
/turf/simulated/floor/carpet/bcarpet,
/area/crawler)
"F" = (
/obj/structure/toilet,
/turf/simulated/floor/tiled/cafe,
/area/crawler)
"G" = (
/obj/machinery/washing_machine,
/turf/simulated/floor/tiled/cafe,
/area/crawler)
"H" = (
/obj/structure/curtain/open/shower,
/obj/machinery/shower{
	dir = 1
	},
/turf/simulated/floor/tiled/cafe,
/area/crawler)
"I" = (
/obj/random/structures/os,
/turf/simulated/floor/wood,
/area/crawler)
"N" = (
/obj/structure/table/onestar,
/obj/random/structures/os,
/turf/simulated/floor/carpet/bcarpet,
/area/crawler)
"O" = (
/obj/random/credits,
/turf/simulated/floor/tiled/cafe,
/area/crawler)
"W" = (
/obj/random/credits,
/turf/simulated/floor/wood,
/area/crawler)
"Y" = (
/obj/structure/table/rack,
/obj/structure/window/reinforced{
	dir = 4
	},
/obj/structure/window/reinforced{
	dir = 8
	},
/obj/random/gun_fancy,
/obj/random/gun_fancy,
/turf/simulated/floor/wood,
/area/crawler)

(1,1,1) = {"
a
a
a
a
a
x
a
a
a
"}
(2,1,1) = {"
a
f
y
A
c
v
O
G
a
"}
(3,1,1) = {"
a
c
c
B
c
a
p
p
a
"}
(4,1,1) = {"
a
g
s
W
c
a
F
H
a
"}
(5,1,1) = {"
a
a
a
a
t
a
a
a
b
"}
(6,1,1) = {"
b
c
c
j
j
j
c
q
b
"}
(7,1,1) = {"
i
c
c
C
E
N
c
r
b
"}
(8,1,1) = {"
b
e
c
N
k
N
c
Y
b
"}
(9,1,1) = {"
a
c
n
D
D
j
W
c
b
"}
(10,1,1) = {"
a
c
c
c
c
c
c
I
a
"}
(11,1,1) = {"
a
h
a
a
u
a
a
h
a
"}
(12,1,1) = {"
a
l
z
m
m
m
z
l
a
"}
(13,1,1) = {"
a
a
x
x
x
x
x
a
a
"}
