//MAP CONVERTED BY dmm2tgm.py THIS HEADER COMMENT PREVENTS RECONVERSION, DO NOT REMOVE
"a" = (
/turf/simulated/wall/untinted/onestar_reinforced,
/area/crawler)
"b" = (
/obj/machinery/power/terminal,
/obj/structure/catwalk,
/obj/random/mob/roomba,
/turf/simulated/floor/tiled/derelict/white_small_edges,
/area/crawler)
"c" = (
/turf/simulated/floor/tiled/derelict,
/area/crawler)
"d" = (
/obj/effect/floor_decal/industrial/warning{
	dir = 4
	},
/turf/simulated/floor/tiled/derelict,
/area/crawler)
"e" = (
/obj/structure/railing/grey{
	dir = 8
	},
/turf/simulated/floor/tiled/derelict/white_small_edges,
/area/crawler)
"g" = (
/turf/simulated/floor/tiled/derelict/white_small_edges,
/area/crawler)
"h" = (
/obj/structure/grille,
/turf/simulated/floor/tiled/techmaint,
/area/crawler)
"i" = (
/obj/structure/disposalpipe/segment{
	dir = 4
	},
/obj/structure/lattice,
/turf/simulated/floor/plating/under,
/area/crawler)
"j" = (
/obj/random/mob/roomba,
/turf/simulated/floor/tiled/derelict,
/area/crawler)
"k" = (
/obj/machinery/power/breakerbox/activated,
/turf/simulated/floor/tiled/techmaint_panels,
/area/crawler)
"l" = (
/obj/random/structures/os,
/turf/simulated/floor/tiled/techmaint_panels,
/area/crawler)
"o" = (
/obj/crawler/crawler_wallbreaker/vertical,
/turf/simulated/wall/untinted/onestar_reinforced,
/area/crawler)
"p" = (
/obj/structure/disposalpipe/segment{
	dir = 4
	},
/obj/structure/lattice,
/obj/random/mob/roomba,
/turf/simulated/floor/plating/under,
/area/crawler)
"r" = (
/obj/effect/floor_decal/industrial/loading{
	dir = 4
	},
/obj/random/powercell,
/turf/simulated/floor/tiled/derelict/white_small_edges,
/area/crawler)
"t" = (
/obj/machinery/power/terminal,
/obj/structure/catwalk,
/turf/simulated/floor/tiled/derelict/white_small_edges,
/area/crawler)
"u" = (
/obj/machinery/power/smes/buildable,
/turf/simulated/floor/tiled/techmaint_panels,
/area/crawler)
"x" = (
/obj/effect/floor_decal/industrial/warning,
/turf/simulated/floor/tiled/derelict,
/area/crawler)
"z" = (
/obj/structure/railing/grey{
	dir = 1
	},
/obj/structure/disposalpipe/segment{
	dir = 4
	},
/obj/structure/lattice,
/turf/simulated/floor/plating/under,
/area/crawler)
"A" = (
/obj/structure/catwalk,
/turf/simulated/floor/plating/under,
/area/crawler)
"C" = (
/obj/crawler/crawler_wallbreaker,
/turf/simulated/wall/untinted/onestar_reinforced,
/area/crawler)
"D" = (
/obj/random/powercell,
/turf/simulated/floor/tiled/derelict,
/area/crawler)
"G" = (
/obj/machinery/power/smes/buildable,
/obj/item/tool_upgrade/augment/cell_mount,
/turf/simulated/floor/tiled/techmaint_panels,
/area/crawler)
"L" = (
/obj/machinery/power/terminal,
/obj/structure/catwalk,
/obj/random/powercell,
/turf/simulated/floor/tiled/derelict/white_small_edges,
/area/crawler)
"Q" = (
/obj/random/powercell,
/turf/simulated/floor/tiled/derelict/white_small_edges,
/area/crawler)
"W" = (
/obj/item/tool_upgrade/augment/cell_mount,
/turf/simulated/floor/tiled/derelict/white_small_edges,
/area/crawler)

(1,1,1) = {"
a
a
a
C
C
o
a
a
a
"}
(2,1,1) = {"
a
i
h
c
c
x
z
A
a
"}
(3,1,1) = {"
a
i
h
c
j
x
z
A
a
"}
(4,1,1) = {"
a
i
h
D
c
x
z
A
a
"}
(5,1,1) = {"
a
h
a
c
j
x
z
A
C
"}
(6,1,1) = {"
C
c
c
c
D
x
z
A
C
"}
(7,1,1) = {"
C
c
c
c
c
x
z
A
C
"}
(8,1,1) = {"
C
d
d
d
d
a
p
A
C
"}
(9,1,1) = {"
a
e
e
r
e
g
Q
g
C
"}
(10,1,1) = {"
a
g
k
b
G
t
u
Q
a
"}
(11,1,1) = {"
a
g
l
L
u
t
u
g
a
"}
(12,1,1) = {"
a
Q
g
g
g
W
g
Q
a
"}
(13,1,1) = {"
a
a
o
o
o
o
o
a
a
"}
