//MAP CONVERTED BY dmm2tgm.py THIS HEADER COMMENT PREVENTS RECONVERSION, DO NOT REMOVE
"a" = (
/turf/simulated/wall/untinted/onestar_reinforced,
/area/crawler)
"b" = (
/obj/crawler/crawler_wallbreaker,
/turf/simulated/wall/untinted/onestar_reinforced,
/area/crawler)
"c" = (
/obj/structure/railing/grey{
	dir = 4
	},
/turf/simulated/floor/tiled/dark/techfloor,
/area/crawler)
"d" = (
/turf/simulated/floor/plating/under,
/area/crawler)
"e" = (
/turf/simulated/floor/tiled/derelict/white_small_edges,
/area/crawler)
"g" = (
/obj/crawler/crawler_wallbreaker/vertical,
/turf/simulated/wall/untinted/onestar_reinforced,
/area/crawler)
"h" = (
/obj/structure/railing,
/turf/simulated/floor/asteroid,
/area/crawler)
"j" = (
/obj/structure/railing/grey{
	dir = 4
	},
/obj/structure/railing/grey,
/turf/simulated/floor/plating/under,
/area/crawler)
"k" = (
/obj/random/mob/roomba/mecha/low,
/turf/simulated/floor/tiled/derelict,
/area/crawler)
"l" = (
/obj/machinery/power/supply_beacon,
/turf/simulated/floor/asteroid,
/area/crawler)
"m" = (
/obj/structure/catwalk,
/turf/space,
/area/crawler)
"n" = (
/turf/simulated/floor/asteroid,
/area/crawler)
"o" = (
/obj/structure/railing{
	dir = 1
	},
/turf/simulated/floor/asteroid,
/area/crawler)
"p" = (
/obj/structure/railing/grey{
	dir = 4
	},
/obj/structure/railing/grey{
	dir = 1
	},
/turf/simulated/floor/plating/under,
/area/crawler)
"r" = (
/turf/simulated/floor/tiled/derelict,
/area/crawler)
"s" = (
/obj/random/mob/roomba/any,
/turf/simulated/floor/tiled/derelict/white_small_edges,
/area/crawler)
"P" = (
/obj/random/structures/os,
/turf/simulated/floor/tiled/derelict/white_small_edges,
/area/crawler)
"R" = (
/obj/random/mob/roomba/any,
/turf/simulated/floor/tiled/derelict,
/area/crawler)
"X" = (
/obj/machinery/door/airlock/external,
/turf/simulated/floor/asteroid,
/area/crawler)
"Y" = (
/obj/structure/lattice,
/obj/effect/window_lwall_spawn/smartspawn/onestar,
/turf/simulated/floor/asteroid,
/area/crawler)

(1,1,1) = {"
a
a
g
g
g
g
g
a
a
"}
(2,1,1) = {"
a
P
s
r
r
r
s
P
a
"}
(3,1,1) = {"
a
P
e
r
R
r
e
P
a
"}
(4,1,1) = {"
a
c
j
r
k
r
p
c
a
"}
(5,1,1) = {"
a
d
a
Y
X
Y
a
d
a
"}
(6,1,1) = {"
a
d
Y
h
m
o
Y
d
b
"}
(7,1,1) = {"
b
d
Y
n
l
n
Y
d
b
"}
(8,1,1) = {"
b
d
Y
h
m
o
Y
d
b
"}
(9,1,1) = {"
b
d
a
Y
X
Y
a
d
b
"}
(10,1,1) = {"
a
c
j
r
k
r
p
c
b
"}
(11,1,1) = {"
a
P
s
r
r
r
s
P
a
"}
(12,1,1) = {"
a
P
e
r
R
r
e
P
a
"}
(13,1,1) = {"
a
a
g
g
g
g
g
a
a
"}
