//MAP CONVERTED BY dmm2tgm.py THIS HEADER COMMENT PREVENTS RECONVERSION, DO NOT REMOVE
"a" = (
/turf/simulated/wall/untinted/onestar_reinforced,
/area/crawler)
"b" = (
/obj/crawler/crawler_wallbreaker,
/turf/simulated/wall/untinted/onestar_reinforced,
/area/crawler)
"c" = (
/obj/random/mob/roomba/any,
/turf/simulated/floor/tiled/dark/techfloor,
/area/crawler)
"d" = (
/turf/simulated/floor/plating/under,
/area/crawler)
"e" = (
/turf/simulated/floor/tiled/derelict/white_small_edges,
/area/crawler)
"f" = (
/obj/structure/lattice,
/obj/structure/grille,
/obj/structure/window/reinforced/full,
/turf/simulated/floor/asteroid,
/area/crawler)
"g" = (
/obj/crawler/crawler_wallbreaker/vertical,
/turf/simulated/wall/untinted/onestar_reinforced,
/area/crawler)
"h" = (
/turf/simulated/floor/asteroid,
/area/crawler)
"i" = (
/obj/structure/railing,
/turf/simulated/floor/asteroid,
/area/crawler)
"j" = (
/obj/machinery/light/floor,
/turf/simulated/floor/tiled/derelict/white_small_edges,
/area/crawler)
"k" = (
/obj/crawler/crawler_wallbreaker/vertical,
/turf/simulated/floor/bluegrid,
/area/crawler)
"l" = (
/obj/structure/catwalk,
/turf/space,
/area/crawler)
"m" = (
/obj/structure/catwalk,
/obj/machinery/door/airlock/external,
/turf/simulated/floor/asteroid,
/area/crawler)
"n" = (
/obj/structure/railing{
	dir = 1
	},
/turf/simulated/floor/asteroid,
/area/crawler)
"o" = (
/obj/structure/railing/grey{
	dir = 4
	},
/turf/simulated/floor/tiled/dark/techfloor,
/area/crawler)
"p" = (
/obj/structure/railing/grey{
	dir = 4
	},
/obj/structure/railing/grey,
/turf/simulated/floor/plating/under,
/area/crawler)
"q" = (
/obj/structure/railing/grey{
	dir = 4
	},
/obj/structure/railing/grey{
	dir = 1
	},
/turf/simulated/floor/plating/under,
/area/crawler)
"r" = (
/turf/simulated/floor/tiled/derelict,
/area/crawler)
"s" = (
/obj/random/mob/roomba/any,
/turf/simulated/floor/tiled/derelict/white_small_edges,
/area/crawler)
"A" = (
/obj/machinery/power/supply_beacon,
/turf/simulated/floor/asteroid,
/area/crawler)
"G" = (
/obj/random/mob/roomba/any,
/turf/simulated/floor/tiled/derelict,
/area/crawler)
"P" = (
/obj/random/structures/os,
/turf/simulated/floor/tiled/derelict/white_small_edges,
/area/crawler)
"R" = (
/obj/machinery/door/airlock/external,
/turf/simulated/floor/asteroid,
/area/crawler)
"X" = (
/obj/random/mob/roomba/mecha/low,
/turf/simulated/floor/tiled/derelict,
/area/crawler)
"Y" = (
/obj/structure/lattice,
/obj/effect/window_lwall_spawn/smartspawn/onestar,
/turf/simulated/floor/asteroid,
/area/crawler)

(1,1,1) = {"
a
a
a
a
a
g
a
a
a
"}
(2,1,1) = {"
a
c
d
d
d
d
d
c
a
"}
(3,1,1) = {"
a
d
a
Y
R
Y
a
d
a
"}
(4,1,1) = {"
a
d
Y
h
h
h
Y
d
a
"}
(5,1,1) = {"
a
d
Y
h
A
h
Y
d
b
"}
(6,1,1) = {"
b
d
Y
h
h
h
Y
d
b
"}
(7,1,1) = {"
b
d
a
i
l
n
a
d
b
"}
(8,1,1) = {"
b
d
a
f
m
f
a
d
b
"}
(9,1,1) = {"
a
o
p
r
X
r
q
o
b
"}
(10,1,1) = {"
a
P
e
r
r
r
e
P
a
"}
(11,1,1) = {"
a
j
s
r
G
r
s
j
a
"}
(12,1,1) = {"
a
P
e
r
r
r
e
P
a
"}
(13,1,1) = {"
a
a
g
k
k
k
g
a
a
"}
