//MAP CONVERTED BY dmm2tgm.py THIS HEADER COMMENT PREVENTS RECONVERSION, DO NOT REMOVE
"a" = (
/turf/simulated/wall/untinted/onestar_reinforced,
/area/crawler)
"b" = (
/obj/crawler/crawler_wallbreaker,
/turf/simulated/wall/untinted/onestar_reinforced,
/area/crawler)
"c" = (
/obj/structure/grille,
/turf/simulated/floor/tiled/techmaint,
/area/crawler)
"e" = (
/obj/structure/grille,
/turf/simulated/floor/tiled/techmaint_panels,
/area/crawler)
"g" = (
/obj/structure/lattice,
/turf/simulated/floor/plating/under,
/area/crawler)
"h" = (
/obj/structure/railing/grey,
/obj/random/structures/os,
/turf/simulated/floor/tiled/techmaint,
/area/crawler)
"k" = (
/obj/structure/railing/grey,
/turf/simulated/floor/plating/under,
/area/crawler)
"l" = (
/obj/crawler/crawler_wallbreaker/vertical,
/turf/simulated/wall/untinted/onestar_reinforced,
/area/crawler)
"u" = (
/obj/structure/catwalk,
/turf/simulated/floor/plating/under,
/area/crawler)
"z" = (
/obj/random/mob/roomba,
/obj/structure/catwalk,
/turf/simulated/floor/plating/under,
/area/crawler)
"H" = (
/obj/structure/railing/grey{
	dir = 1
	},
/obj/random/structures/os,
/turf/simulated/floor/tiled/techmaint,
/area/crawler)
"K" = (
/obj/structure/railing/grey{
	dir = 1
	},
/turf/simulated/floor/plating/under,
/area/crawler)

(1,1,1) = {"
a
a
a
l
l
l
a
a
a
"}
(2,1,1) = {"
a
c
h
u
u
u
H
c
a
"}
(3,1,1) = {"
a
c
h
u
u
u
H
c
a
"}
(4,1,1) = {"
a
g
k
u
u
u
K
g
a
"}
(5,1,1) = {"
a
e
a
u
z
u
a
e
b
"}
(6,1,1) = {"
b
g
k
u
u
u
K
g
b
"}
(7,1,1) = {"
b
g
k
u
u
u
K
g
b
"}
(8,1,1) = {"
b
g
k
u
u
u
K
g
b
"}
(9,1,1) = {"
a
e
a
u
z
u
a
e
b
"}
(10,1,1) = {"
a
g
k
u
u
u
K
g
a
"}
(11,1,1) = {"
a
c
h
u
u
u
H
c
a
"}
(12,1,1) = {"
a
c
h
u
u
u
H
c
a
"}
(13,1,1) = {"
a
a
l
l
l
l
l
a
a
"}
