//MAP CONVERTED BY dmm2tgm.py THIS HEADER COMMENT PREVENTS RECONVERSION, DO NOT REMOVE
"a" = (
/turf/simulated/wall/untinted/onestar_reinforced,
/area/crawler)
"b" = (
/obj/structure/noticeboard,
/turf/simulated/wall/untinted/onestar_reinforced,
/area/crawler)
"d" = (
/turf/simulated/floor/wood,
/area/crawler)
"e" = (
/obj/structure/bed/chair/office/dark,
/turf/simulated/floor/wood,
/area/crawler)
"f" = (
/obj/structure/window/reinforced/polarized{
	dir = 4;
	id = 10
	},
/turf/simulated/floor/wood,
/area/crawler)
"g" = (
/turf/simulated/floor/tiled/derelict,
/area/crawler)
"h" = (
/obj/structure/window/reinforced/polarized{
	dir = 8;
	id = 11
	},
/turf/simulated/floor/wood,
/area/crawler)
"j" = (
/obj/structure/table/onestar,
/turf/simulated/floor/tiled/techmaint,
/area/crawler)
"k" = (
/obj/structure/table/onestar,
/turf/simulated/floor/wood,
/area/crawler)
"m" = (
/obj/crawler/crawler_wallbreaker/vertical,
/turf/simulated/wall/untinted/onestar_reinforced,
/area/crawler)
"n" = (
/obj/structure/bed/chair/office/dark{
	dir = 4
	},
/turf/simulated/floor/wood,
/area/crawler)
"o" = (
/obj/effect/floor_decal/fact_plaque,
/turf/simulated/floor/tiled/derelict,
/area/crawler)
"p" = (
/obj/structure/bed/chair/office/dark{
	dir = 8
	},
/turf/simulated/floor/wood,
/area/crawler)
"q" = (
/obj/structure/window/reinforced/polarized{
	dir = 4;
	id = 10
	},
/obj/structure/window/reinforced/polarized{
	id = 10
	},
/turf/simulated/floor/wood,
/area/crawler)
"r" = (
/obj/structure/window/reinforced/polarized{
	dir = 8;
	id = 11
	},
/obj/structure/window/reinforced/polarized{
	id = 11
	},
/turf/simulated/floor/wood,
/area/crawler)
"s" = (
/obj/structure/bed/chair/office/dark{
	dir = 1
	},
/turf/simulated/floor/wood,
/area/crawler)
"t" = (
/obj/random/mob/roomba,
/turf/simulated/floor/tiled/derelict,
/area/crawler)
"u" = (
/obj/structure/window/reinforced/polarized{
	dir = 4;
	id = 10
	},
/turf/simulated/floor/tiled/derelict/white_small_edges,
/area/crawler)
"v" = (
/obj/structure/window/reinforced/polarized{
	dir = 8;
	id = 11
	},
/turf/simulated/floor/tiled/derelict/white_small_edges,
/area/crawler)
"w" = (
/obj/structure/closet/onestar/tier1,
/turf/simulated/floor/wood,
/area/crawler)
"x" = (
/obj/random/structures/os,
/turf/simulated/floor/wood,
/area/crawler)
"y" = (
/obj/structure/window/reinforced/polarized{
	dir = 4;
	id = 10
	},
/obj/structure/table/onestar,
/turf/simulated/floor/wood,
/area/crawler)
"z" = (
/turf/simulated/floor/tiled/derelict/white_small_edges,
/area/crawler)
"A" = (
/obj/structure/window/reinforced/polarized{
	dir = 8;
	id = 11
	},
/obj/structure/table/onestar,
/turf/simulated/floor/wood,
/area/crawler)
"B" = (
/obj/crawler/crawler_wallbreaker,
/turf/simulated/wall/untinted/onestar_reinforced,
/area/crawler)
"C" = (
/obj/structure/closet/onestar/tier2,
/turf/simulated/floor/wood,
/area/crawler)
"E" = (
/obj/structure/table/onestar,
/obj/random/junkfood,
/turf/simulated/floor/wood,
/area/crawler)
"H" = (
/obj/random/junkfood/onlypizza,
/turf/simulated/floor/tiled/derelict,
/area/crawler)
"K" = (
/obj/structure/table/onestar,
/obj/random/junkfood/onlyburger,
/turf/simulated/floor/tiled/techmaint,
/area/crawler)
"N" = (
/obj/structure/table/onestar,
/obj/random/junkfood,
/turf/simulated/floor/tiled/techmaint,
/area/crawler)
"Q" = (
/obj/structure/table/onestar,
/obj/random/structures/os,
/turf/simulated/floor/wood,
/area/crawler)
"X" = (
/obj/structure/table/onestar,
/obj/random/junkfood/onlyburger,
/turf/simulated/floor/wood,
/area/crawler)
"Y" = (
/obj/structure/table/onestar,
/obj/random/structures/os,
/turf/simulated/floor/tiled/techmaint,
/area/crawler)

(1,1,1) = {"
a
a
a
a
a
m
a
a
a
"}
(2,1,1) = {"
a
d
s
n
e
d
d
x
a
"}
(3,1,1) = {"
b
e
j
Y
N
d
d
x
a
"}
(4,1,1) = {"
a
e
N
K
j
p
d
y
a
"}
(5,1,1) = {"
a
f
f
f
f
q
u
z
B
"}
(6,1,1) = {"
B
g
g
g
g
g
t
g
B
"}
(7,1,1) = {"
B
g
t
H
o
g
g
g
B
"}
(8,1,1) = {"
B
g
g
g
g
g
g
t
B
"}
(9,1,1) = {"
a
h
h
h
h
r
v
z
B
"}
(10,1,1) = {"
a
e
E
X
Q
s
d
A
a
"}
(11,1,1) = {"
a
e
k
k
E
s
d
x
a
"}
(12,1,1) = {"
a
w
e
d
p
d
d
C
a
"}
(13,1,1) = {"
a
a
m
m
m
m
m
a
a
"}
