//MAP CONVERTED BY dmm2tgm.py THIS HEADER COMMENT PREVENTS RECONVERSION, DO NOT REMOVE
"a" = (
/turf/simulated/wall/untinted/onestar_reinforced,
/area/crawler)
"c" = (
/turf/simulated/floor/asteroid/grass,
/area/crawler)
"d" = (
/obj/structure/railing/grey{
	dir = 4
	},
/turf/simulated/floor/tiled/derelict/white_small_edges,
/area/crawler)
"e" = (
/turf/simulated/floor/tiled/derelict,
/area/crawler)
"f" = (
/obj/structure/railing/grey{
	dir = 8
	},
/turf/simulated/floor/tiled/derelict/white_small_edges,
/area/crawler)
"g" = (
/obj/structure/railing/grey,
/turf/simulated/floor/tiled/derelict/white_small_edges,
/area/crawler)
"h" = (
/obj/random/mob/roomba,
/turf/simulated/floor/tiled/derelict,
/area/crawler)
"j" = (
/obj/crawler/crawler_wallbreaker/vertical,
/turf/simulated/wall/untinted/onestar_reinforced,
/area/crawler)
"o" = (
/obj/structure/railing/grey{
	dir = 1
	},
/turf/simulated/floor/tiled/derelict/white_small_edges,
/area/crawler)
"p" = (
/obj/crawler/crawler_wallbreaker,
/turf/simulated/wall/untinted/onestar_reinforced,
/area/crawler)
"Y" = (
/obj/random/structures/os,
/turf/simulated/floor/asteroid/grass,
/area/crawler)

(1,1,1) = {"
a
a
a
j
j
j
a
a
a
"}
(2,1,1) = {"
a
c
g
e
e
e
o
c
a
"}
(3,1,1) = {"
a
Y
g
e
e
e
o
Y
a
"}
(4,1,1) = {"
a
c
g
e
h
e
o
c
a
"}
(5,1,1) = {"
a
d
a
e
e
e
a
d
p
"}
(6,1,1) = {"
p
e
e
e
h
e
e
e
p
"}
(7,1,1) = {"
p
e
e
e
e
e
e
e
p
"}
(8,1,1) = {"
p
e
e
e
e
e
e
e
p
"}
(9,1,1) = {"
a
f
a
e
e
e
a
f
p
"}
(10,1,1) = {"
a
c
g
e
e
e
o
c
a
"}
(11,1,1) = {"
a
Y
g
e
h
e
o
Y
a
"}
(12,1,1) = {"
a
c
g
e
e
e
o
c
a
"}
(13,1,1) = {"
a
a
j
j
j
j
j
a
a
"}
