//MAP CONVERTED BY dmm2tgm.py THIS HEADER COMMENT PREVENTS RECONVERSION, DO NOT REMOVE
"a" = (
/turf/simulated/wall/untinted/onestar_reinforced,
/area/crawler)
"b" = (
/obj/structure/extinguisher_cabinet,
/turf/simulated/wall/untinted/onestar_reinforced,
/area/crawler)
"d" = (
/obj/machinery/antigrav,
/turf/simulated/floor/bluegrid,
/area/crawler)
"f" = (
/obj/structure/window/reinforced{
	dir = 4
	},
/turf/simulated/floor/tiled/dark/techfloor,
/area/crawler)
"g" = (
/obj/effect/floor_decal/industrial/warning/corner{
	dir = 8
	},
/turf/simulated/floor/tiled/derelict,
/area/crawler)
"h" = (
/turf/simulated/floor/tiled/derelict,
/area/crawler)
"i" = (
/obj/effect/floor_decal/industrial/warning/corner,
/turf/simulated/floor/tiled/derelict,
/area/crawler)
"j" = (
/obj/structure/window/reinforced{
	dir = 8
	},
/turf/simulated/floor/tiled/dark/techfloor,
/area/crawler)
"k" = (
/obj/structure/salvageable/computer_os,
/turf/simulated/floor/bluegrid,
/area/crawler)
"l" = (
/obj/structure/salvageable/console_os,
/turf/simulated/floor/bluegrid,
/area/crawler)
"m" = (
/obj/machinery/light/floor,
/turf/simulated/floor/tiled/derelict,
/area/crawler)
"n" = (
/turf/simulated/floor/tiled/dark/techfloor_grid,
/area/crawler)
"o" = (
/obj/machinery/door/window/eastright,
/turf/simulated/floor/tiled/dark/techfloor,
/area/crawler)
"p" = (
/obj/effect/floor_decal/industrial/warning{
	dir = 8
	},
/turf/simulated/floor/tiled/derelict,
/area/crawler)
"q" = (
/obj/effect/floor_decal/industrial/warning{
	dir = 4
	},
/turf/simulated/floor/tiled/derelict,
/area/crawler)
"r" = (
/obj/machinery/door/window/westright,
/turf/simulated/floor/tiled/dark/techfloor,
/area/crawler)
"s" = (
/obj/random/mob/roomba,
/turf/simulated/floor/tiled/derelict,
/area/crawler)
"t" = (
/obj/crawler/crawler_wallbreaker/vertical,
/turf/simulated/wall/untinted/onestar_reinforced,
/area/crawler)
"u" = (
/obj/machinery/field_generator,
/turf/simulated/floor/bluegrid,
/area/crawler)
"v" = (
/obj/effect/floor_decal/industrial/warning/corner{
	dir = 1
	},
/turf/simulated/floor/tiled/derelict,
/area/crawler)
"w" = (
/obj/effect/floor_decal/industrial/warning/corner{
	dir = 4;
	icon_state = "warningcorner"
	},
/turf/simulated/floor/tiled/derelict,
/area/crawler)
"z" = (
/obj/structure/salvageable/data_os,
/turf/simulated/floor/bluegrid,
/area/crawler)
"A" = (
/obj/structure/closet/onestar/tier2,
/turf/simulated/floor/bluegrid,
/area/crawler)
"B" = (
/obj/structure/closet/onestar/tier3,
/turf/simulated/floor/bluegrid,
/area/crawler)
"C" = (
/obj/machinery/constructable_frame/machine_frame,
/turf/simulated/floor/bluegrid,
/area/crawler)
"D" = (
/obj/structure/window/reinforced{
	dir = 4
	},
/obj/random/toolbox,
/turf/simulated/floor/tiled/dark/techfloor,
/area/crawler)
"F" = (
/obj/structure/salvageable/implant_container_os,
/turf/simulated/floor/bluegrid,
/area/crawler)
"I" = (
/obj/structure/salvageable/console_os{
	dir = 1
	},
/turf/simulated/floor/bluegrid,
/area/crawler)
"J" = (
/obj/crawler/crawler_wallbreaker,
/turf/simulated/wall/untinted/onestar_reinforced,
/area/crawler)
"Q" = (
/obj/structure/window/reinforced{
	dir = 8
	},
/obj/structure/salvageable/data_os,
/turf/simulated/floor/tiled/dark/techfloor,
/area/crawler)
"T" = (
/obj/structure/salvageable/console_broken_os,
/turf/simulated/floor/bluegrid,
/area/crawler)
"X" = (
/obj/structure/salvageable/machine_os,
/turf/simulated/floor/bluegrid,
/area/crawler)

(1,1,1) = {"
a
a
a
a
a
t
a
a
a
"}
(2,1,1) = {"
a
d
n
z
a
B
n
I
a
"}
(3,1,1) = {"
a
A
n
u
a
z
n
I
a
"}
(4,1,1) = {"
a
A
n
u
a
C
n
I
a
"}
(5,1,1) = {"
b
f
o
f
b
D
o
f
J
"}
(6,1,1) = {"
J
g
p
v
m
g
p
v
J
"}
(7,1,1) = {"
J
h
s
h
s
s
h
h
J
"}
(8,1,1) = {"
J
i
q
w
m
i
q
w
J
"}
(9,1,1) = {"
b
Q
r
Q
a
j
r
j
J
"}
(10,1,1) = {"
a
k
n
z
a
F
n
I
a
"}
(11,1,1) = {"
a
l
n
B
a
F
n
I
a
"}
(12,1,1) = {"
a
T
n
z
a
X
n
I
a
"}
(13,1,1) = {"
a
a
t
t
t
t
t
a
a
"}
