//MAP CONVERTED BY dmm2tgm.py THIS HEADER COMMENT PREVENTS RECONVERSION, DO NOT REMOVE
"a" = (
/turf/simulated/wall/untinted/onestar_reinforced,
/area/crawler)
"b" = (
/obj/crawler/crawler_wallbreaker,
/turf/simulated/wall/untinted/onestar_reinforced,
/area/crawler)
"c" = (
/turf/simulated/mineral/random/high_chance,
/area/crawler)
"d" = (
/turf/simulated/floor/tiled/derelict/white_small_edges,
/area/crawler)
"f" = (
/obj/crawler/crawler_wallbreaker/vertical,
/turf/simulated/wall/untinted/onestar_reinforced,
/area/crawler)
"g" = (
/turf/simulated/floor/bluegrid,
/area/crawler)
"h" = (
/turf/simulated/floor/tiled/derelict,
/area/crawler)
"i" = (
/obj/crawler/crawler_wallbreaker/vertical,
/turf/simulated/floor/bluegrid,
/area/crawler)
"j" = (
/obj/item/tool/pickaxe/jackhammer/onestar,
/turf/simulated/floor/tiled/derelict,
/area/crawler)
"k" = (
/obj/crawler/crawler_wallbreaker,
/turf/simulated/floor/bluegrid,
/area/crawler)
"n" = (
/obj/random/structures/os,
/turf/simulated/floor/tiled/derelict/white_small_edges,
/area/crawler)
"x" = (
/obj/item/tool/pickaxe/onestar,
/turf/simulated/floor/tiled/derelict/white_small_edges,
/area/crawler)
"y" = (
/obj/item/tool/pickaxe/jackhammer/onestar,
/turf/simulated/floor/tiled/derelict/white_small_edges,
/area/crawler)
"O" = (
/obj/item/tool/pickaxe/drill/onestar,
/turf/simulated/floor/tiled/derelict/white_small_edges,
/area/crawler)
"R" = (
/obj/item/tool/pickaxe/onestar,
/turf/simulated/floor/tiled/derelict,
/area/crawler)
"T" = (
/obj/item/tool/pickaxe/drill/onestar,
/turf/simulated/floor/tiled/derelict,
/area/crawler)

(1,1,1) = {"
a
a
a
g
g
i
a
a
a
"}
(2,1,1) = {"
a
c
d
h
h
h
d
x
a
"}
(3,1,1) = {"
a
c
c
h
h
h
d
c
a
"}
(4,1,1) = {"
a
c
c
h
T
h
c
c
a
"}
(5,1,1) = {"
a
c
y
h
h
c
c
c
b
"}
(6,1,1) = {"
b
d
d
c
c
c
c
c
k
"}
(7,1,1) = {"
b
c
c
c
c
c
c
c
k
"}
(8,1,1) = {"
b
c
c
c
c
c
c
c
k
"}
(9,1,1) = {"
a
c
c
c
c
c
c
c
b
"}
(10,1,1) = {"
a
c
c
c
c
c
c
O
a
"}
(11,1,1) = {"
a
c
c
c
R
h
d
d
a
"}
(12,1,1) = {"
a
c
c
j
h
h
d
n
a
"}
(13,1,1) = {"
a
a
f
i
i
i
f
a
a
"}
