//MAP CONVERTED BY dmm2tgm.py THIS HEADER COMMENT PREVENTS RECONVERSION, DO NOT REMOVE
"a" = (
/turf/simulated/wall/untinted/onestar_reinforced,
/area/crawler)
"b" = (
/obj/crawler/crawler_wallbreaker,
/turf/simulated/wall/untinted/onestar_reinforced,
/area/crawler)
"c" = (
/obj/structure/railing/grey{
	dir = 4
	},
/turf/simulated/floor/plating/under,
/area/crawler)
"d" = (
/obj/structure/catwalk,
/turf/simulated/floor/plating/under,
/area/crawler)
"e" = (
/turf/simulated/floor/tiled/derelict/red_white_edges,
/area/crawler)
"f" = (
/turf/simulated/floor/tiled/dark/brown_perforated,
/area/crawler)
"g" = (
/turf/simulated/floor/tiled/dark/brown_platform,
/area/crawler)
"i" = (
/obj/structure/table/onestar,
/turf/simulated/floor/tiled/dark/brown_perforated,
/area/crawler)
"j" = (
/turf/simulated/floor/plating/under,
/area/crawler)
"k" = (
/obj/structure/railing/grey,
/obj/structure/railing/grey{
	dir = 4
	},
/obj/random/structures/os,
/turf/simulated/floor/plating/under,
/area/crawler)
"l" = (
/obj/structure/salvageable/console_os{
	dir = 4
	},
/turf/simulated/floor/tiled/dark/brown_perforated,
/area/crawler)
"m" = (
/obj/structure/bed/chair/custom/onestar/red,
/turf/simulated/floor/tiled/dark/brown_platform,
/area/crawler)
"n" = (
/obj/structure/railing/grey,
/turf/simulated/floor/plating/under,
/area/crawler)
"o" = (
/obj/crawler/crawler_wallbreaker/vertical,
/turf/simulated/wall/untinted/onestar_reinforced,
/area/crawler)
"q" = (
/obj/effect/floor_decal/industrial/warning{
	dir = 4
	},
/turf/simulated/floor/tiled/derelict,
/area/crawler)
"r" = (
/obj/structure/catwalk,
/turf/simulated/floor/tiled/derelict,
/area/crawler)
"s" = (
/obj/structure/sign/faction/one_star,
/turf/simulated/wall/untinted/onestar_reinforced,
/area/crawler)
"t" = (
/obj/random/mob/roomba,
/turf/simulated/floor/tiled/derelict,
/area/crawler)
"u" = (
/turf/simulated/floor/tiled/derelict,
/area/crawler)
"v" = (
/obj/effect/floor_decal/industrial/warning/corner{
	dir = 4
	},
/turf/simulated/floor/tiled/derelict,
/area/crawler)
"w" = (
/obj/effect/floor_decal/industrial/warning{
	dir = 1
	},
/turf/simulated/floor/tiled/derelict,
/area/crawler)
"x" = (
/obj/effect/floor_decal/industrial/warning,
/obj/machinery/door/window/southright,
/turf/simulated/floor/tiled/dark/brown_perforated,
/area/crawler)
"y" = (
/obj/structure/bed,
/turf/simulated/floor/tiled/dark/brown_platform,
/area/crawler)
"z" = (
/obj/effect/floor_decal/industrial/warning,
/obj/structure/window/reinforced,
/turf/simulated/floor/tiled/dark/brown_perforated,
/area/crawler)
"A" = (
/obj/effect/floor_decal/industrial/warning,
/obj/machinery/door/window/southleft,
/turf/simulated/floor/tiled/dark/brown_perforated,
/area/crawler)
"C" = (
/obj/effect/window_lwall_spawn/smartspawn/onestar,
/turf/simulated/floor/tiled/dark/brown_perforated,
/area/crawler)
"M" = (
/obj/structure/table/onestar,
/obj/random/structures/os,
/turf/simulated/floor/tiled/dark/brown_perforated,
/area/crawler)
"X" = (
/obj/random/structures/os,
/turf/simulated/floor/plating/under,
/area/crawler)

(1,1,1) = {"
a
a
a
b
b
b
a
a
a
"}
(2,1,1) = {"
a
c
k
q
v
u
z
y
a
"}
(3,1,1) = {"
a
d
d
r
w
u
x
g
a
"}
(4,1,1) = {"
a
e
a
s
u
u
a
a
a
"}
(5,1,1) = {"
a
f
l
a
u
u
z
y
b
"}
(6,1,1) = {"
b
g
g
C
u
t
x
g
b
"}
(7,1,1) = {"
b
g
m
C
u
u
a
a
b
"}
(8,1,1) = {"
b
g
g
C
u
u
A
g
b
"}
(9,1,1) = {"
a
M
i
a
t
u
z
y
b
"}
(10,1,1) = {"
a
a
a
s
u
u
a
a
a
"}
(11,1,1) = {"
a
j
n
u
u
u
A
g
a
"}
(12,1,1) = {"
a
X
n
u
u
u
z
y
a
"}
(13,1,1) = {"
a
a
o
b
b
b
o
a
a
"}
