//MAP CONVERTED BY dmm2tgm.py THIS HEADER COMMENT PREVENTS RECONVERSION, DO NOT REMOVE
"a" = (
/turf/simulated/wall/untinted/onestar_reinforced,
/area/crawler)
"b" = (
/obj/structure/noticeboard,
/turf/simulated/wall/untinted/onestar_reinforced,
/area/crawler)
"c" = (
/obj/crawler/crawler_wallbreaker,
/turf/simulated/wall/untinted/onestar_reinforced,
/area/crawler)
"d" = (
/obj/structure/ore_box,
/obj/effect/floor_decal/industrial/outline/yellow,
/turf/simulated/floor/tiled/derelict,
/area/crawler)
"e" = (
/obj/machinery/conveyor_switch/oneway{
	id = 1
	},
/turf/simulated/floor/tiled/derelict/white_big_edges,
/area/crawler)
"f" = (
/turf/simulated/floor/tiled/derelict,
/area/crawler)
"g" = (
/obj/machinery/mineral/processing_unit_console,
/turf/simulated/wall/untinted/onestar_reinforced,
/area/crawler)
"h" = (
/obj/machinery/mineral/stacking_unit_console,
/turf/simulated/wall/untinted/onestar_reinforced,
/area/crawler)
"i" = (
/obj/structure/railing/grey{
	dir = 4
	},
/obj/effect/floor_decal/industrial/hatch/yellow,
/obj/random/structures/os,
/turf/simulated/floor/tiled/derelict,
/area/crawler)
"j" = (
/obj/machinery/conveyor/northeast{
	id = 1
	},
/turf/simulated/floor/tiled/techmaint,
/area/crawler)
"k" = (
/obj/machinery/mineral/processing_unit,
/turf/simulated/floor/tiled/techmaint,
/area/crawler)
"l" = (
/obj/machinery/conveyor/southeast{
	id = 1
	},
/turf/simulated/floor/tiled/techmaint,
/area/crawler)
"m" = (
/obj/structure/bed/chair/office/dark,
/obj/random/material,
/turf/simulated/floor/plating,
/area/crawler)
"n" = (
/obj/structure/railing/grey{
	dir = 4
	},
/obj/structure/railing/grey,
/obj/effect/floor_decal/industrial/hatch/yellow,
/obj/structure/salvageable/console_os{
	dir = 8
	},
/turf/simulated/floor/tiled/derelict,
/area/crawler)
"o" = (
/obj/crawler/crawler_wallbreaker/vertical,
/turf/simulated/wall/untinted/onestar_reinforced,
/area/crawler)
"q" = (
/turf/simulated/floor/tiled/derelict/white_big_edges,
/area/crawler)
"r" = (
/obj/effect/floor_decal/industrial/loading{
	dir = 4
	},
/turf/simulated/floor/tiled/derelict/white_big_edges,
/area/crawler)
"s" = (
/obj/effect/floor_decal/industrial/danger{
	dir = 8
	},
/obj/machinery/mineral/unloading_machine,
/turf/simulated/floor/tiled/techmaint,
/area/crawler)
"t" = (
/obj/machinery/conveyor/northeast/ccw{
	id = 1
	},
/obj/random/material_rare,
/turf/simulated/floor/tiled/techmaint,
/area/crawler)
"u" = (
/obj/machinery/mineral/stacking_machine,
/turf/simulated/floor/tiled/techmaint,
/area/crawler)
"v" = (
/turf/simulated/floor/plating,
/area/crawler)
"w" = (
/obj/machinery/conveyor/south{
	id = 1
	},
/turf/simulated/floor/tiled/techmaint,
/area/crawler)
"x" = (
/obj/effect/floor_decal/industrial/hatch/yellow,
/turf/simulated/floor/tiled/derelict/white_small_edges,
/area/crawler)
"y" = (
/obj/effect/floor_decal/industrial/danger{
	dir = 8
	},
/obj/random/material,
/turf/simulated/floor/tiled/derelict/white_small_edges,
/area/crawler)
"A" = (
/obj/structure/salvageable/autolathe_os,
/turf/simulated/floor/tiled/derelict/white_big_edges,
/area/crawler)
"B" = (
/obj/effect/floor_decal/industrial/danger{
	dir = 8
	},
/obj/random/material_resources,
/turf/simulated/floor/tiled/techmaint,
/area/crawler)
"C" = (
/obj/machinery/conveyor/northwest/ccw{
	id = 1
	},
/turf/simulated/floor/tiled/techmaint,
/area/crawler)
"D" = (
/obj/effect/floor_decal/industrial/loading{
	dir = 8
	},
/turf/simulated/floor/tiled/derelict/white_big_edges,
/area/crawler)
"E" = (
/obj/structure/plushie/beepsky,
/turf/simulated/floor/tiled/derelict/white_big_edges,
/area/crawler)
"G" = (
/obj/machinery/conveyor/northwest{
	id = 1
	},
/turf/simulated/floor/tiled/techmaint,
/area/crawler)
"H" = (
/obj/machinery/conveyor/west{
	id = 1
	},
/obj/structure/plasticflaps/mining,
/turf/simulated/floor/tiled/techmaint,
/area/crawler)
"I" = (
/obj/machinery/conveyor/southwest{
	id = 1
	},
/obj/random/material_rare,
/turf/simulated/floor/tiled/techmaint,
/area/crawler)
"J" = (
/obj/structure/table/onestar,
/obj/random/structures/os,
/turf/simulated/floor/plating,
/area/crawler)
"K" = (
/obj/structure/railing/grey{
	dir = 4
	},
/obj/structure/railing/grey{
	dir = 1
	},
/obj/effect/floor_decal/industrial/hatch/yellow,
/obj/random/structures/os,
/turf/simulated/floor/tiled/derelict,
/area/crawler)
"L" = (
/obj/structure/table/onestar,
/obj/random/material,
/obj/random/material,
/obj/random/material,
/turf/simulated/floor/plating,
/area/crawler)
"M" = (
/obj/random/mob/roomba,
/turf/simulated/floor/tiled/derelict/white_big_edges,
/area/crawler)
"Q" = (
/obj/random/material_resources,
/turf/simulated/floor/tiled/derelict/white_big_edges,
/area/crawler)
"R" = (
/obj/random/material,
/turf/simulated/floor/tiled/derelict/white_big_edges,
/area/crawler)
"S" = (
/obj/random/material_resources,
/turf/simulated/floor/tiled/derelict,
/area/crawler)
"T" = (
/obj/effect/floor_decal/industrial/outline/yellow,
/obj/random/structures/os,
/turf/simulated/floor/tiled/derelict,
/area/crawler)
"V" = (
/obj/random/structures/os,
/turf/simulated/floor/tiled/derelict/white_big_edges,
/area/crawler)

(1,1,1) = {"
a
a
a
o
o
o
a
a
a
"}
(2,1,1) = {"
a
d
d
q
q
q
T
T
a
"}
(3,1,1) = {"
a
f
f
q
M
q
f
f
a
"}
(4,1,1) = {"
a
d
d
M
q
Q
T
T
a
"}
(5,1,1) = {"
b
f
S
r
M
D
f
f
c
"}
(6,1,1) = {"
c
i
n
s
x
B
K
i
c
"}
(7,1,1) = {"
c
a
j
t
q
C
G
a
c
"}
(8,1,1) = {"
c
a
k
a
q
e
H
a
c
"}
(9,1,1) = {"
a
a
l
u
w
w
I
a
c
"}
(10,1,1) = {"
a
a
a
a
y
a
a
a
a
"}
(11,1,1) = {"
a
g
m
q
q
R
J
a
a
"}
(12,1,1) = {"
a
h
v
V
A
E
L
a
a
"}
(13,1,1) = {"
a
a
o
o
o
o
o
a
a
"}
