//MAP CONVERTED BY dmm2tgm.py THIS HEADER COMMENT PREVENTS RECONVERSION, DO NOT REMOVE
"a" = (
/turf/simulated/wall/untinted/onestar_reinforced,
/area/crawler)
"b" = (
/obj/crawler/crawler_wallbreaker,
/turf/simulated/wall/untinted/onestar_reinforced,
/area/crawler)
"c" = (
/obj/structure/table/onestar,
/obj/item/storage/hcases/ammo/blackmarket/has_items_spawn,
/obj/item/storage/hcases/ammo/blackmarket/has_items_spawn,
/obj/item/storage/hcases/ammo/blackmarket/has_items_spawn,
/turf/simulated/floor/tiled/derelict/white_small_edges,
/area/crawler)
"d" = (
/obj/structure/closet/onestar/tier3/special,
/turf/simulated/floor/tiled/derelict,
/area/crawler)
"e" = (
/turf/simulated/floor/tiled/derelict,
/area/crawler)
"f" = (
/obj/structure/grille,
/turf/simulated/floor/tiled/derelict/white_small_edges,
/area/crawler)
"g" = (
/turf/simulated/floor/tiled/derelict/white_small_edges,
/area/crawler)
"h" = (
/obj/structure/table/onestar,
/obj/item/storage/hcases/ammo/excel/has_items_spawn,
/obj/item/storage/hcases/ammo/excel/has_items_spawn,
/obj/item/storage/hcases/ammo/excel/has_items_spawn,
/turf/simulated/floor/tiled/derelict/white_small_edges,
/area/crawler)
"k" = (
/obj/structure/railing/grey{
	dir = 1
	},
/turf/simulated/floor/tiled/derelict,
/area/crawler)
"l" = (
/obj/crawler/crawler_wallbreaker/vertical,
/turf/simulated/wall/untinted/onestar_reinforced,
/area/crawler)
"m" = (
/obj/structure/table/onestar,
/obj/item/clothing/head/helmet/laserproof/iron_lock_security,
/turf/simulated/floor/tiled/derelict/white_small_edges,
/area/crawler)
"n" = (
/turf/simulated/floor/tiled/derelict/white_big_edges,
/area/crawler)
"o" = (
/obj/random/mob/roomba,
/turf/simulated/floor/tiled/derelict/white_big_edges,
/area/crawler)
"p" = (
/obj/structure/target_stake,
/obj/item/target/syndicate,
/turf/simulated/floor/tiled/derelict/white_big_edges,
/area/crawler)
"r" = (
/obj/structure/safe/floor{
	contents = newlist(/obj/random/credits/c1000)
	},
/obj/item/tool/crowbar/onestar,
/obj/item/gun/energy/captain,
/obj/item/computer_hardware/hard_drive/portable/design/onestar/cog,
/turf/simulated/floor/tiled/derelict,
/area/crawler)
"t" = (
/obj/structure/railing/grey,
/turf/simulated/floor/tiled/derelict,
/area/crawler)
"u" = (
/obj/structure/window/reinforced{
	dir = 8
	},
/obj/machinery/door/window/northleft,
/obj/structure/table/rack,
/obj/random/gun_normal,
/obj/random/gun_normal,
/obj/random/gun_cheap,
/turf/simulated/floor/tiled/derelict,
/area/crawler)
"v" = (
/obj/structure/window/reinforced{
	dir = 4
	},
/obj/machinery/door/window/northright,
/obj/structure/table/rack,
/obj/random/gun_shotgun,
/obj/random/gun_normal,
/obj/random/gun_cheap,
/turf/simulated/floor/tiled/derelict,
/area/crawler)
"w" = (
/obj/structure/table/onestar,
/obj/random/gun_normal,
/obj/random/gun_cheap,
/turf/simulated/floor/tiled/derelict,
/area/crawler)
"x" = (
/obj/structure/mopbucket,
/turf/simulated/floor/tiled/derelict/white_small_edges,
/area/crawler)
"y" = (
/obj/random/mob/roomba,
/turf/simulated/floor/tiled/derelict/white_small_edges,
/area/crawler)
"z" = (
/obj/structure/table/onestar,
/obj/random/gun_energy_cheap,
/obj/random/gun_cheap,
/turf/simulated/floor/tiled/derelict,
/area/crawler)

(1,1,1) = {"
a
a
a
l
l
l
a
a
a
"}
(2,1,1) = {"
a
d
g
y
g
g
g
u
a
"}
(3,1,1) = {"
a
d
g
g
g
g
g
v
a
"}
(4,1,1) = {"
a
d
g
g
g
g
y
w
a
"}
(5,1,1) = {"
a
d
y
g
g
g
g
z
b
"}
(6,1,1) = {"
b
n
n
n
n
n
n
n
b
"}
(7,1,1) = {"
b
n
n
n
n
n
n
n
b
"}
(8,1,1) = {"
b
n
n
n
n
o
n
n
b
"}
(9,1,1) = {"
a
f
a
c
m
h
a
f
b
"}
(10,1,1) = {"
a
g
k
e
e
e
t
g
a
"}
(11,1,1) = {"
a
y
e
p
r
p
e
y
a
"}
(12,1,1) = {"
a
g
k
e
e
e
t
x
a
"}
(13,1,1) = {"
a
a
l
l
l
l
l
a
a
"}
