//MAP CONVERTED BY dmm2tgm.py THIS HEADER COMMENT PREVENTS RECONVERSION, DO NOT REMOVE
"a" = (
/turf/simulated/wall/untinted/onestar_reinforced,
/area/crawler)
"c" = (
/turf/simulated/floor/tiled/cafe,
/area/crawler)
"d" = (
/obj/machinery/optable,
/turf/simulated/floor/tiled/cafe,
/area/crawler)
"e" = (
/obj/structure/curtain/medical,
/obj/effect/window_lwall_spawn/smartspawn/onestar,
/turf/simulated/floor/tiled/derelict/white_small_edges,
/area/crawler)
"f" = (
/obj/crawler/crawler_wallbreaker/vertical,
/turf/simulated/wall/untinted/onestar_reinforced,
/area/crawler)
"h" = (
/obj/structure/table/onestar,
/obj/random/medical,
/obj/random/medical,
/obj/random/medical,
/turf/simulated/floor/tiled/cafe,
/area/crawler)
"i" = (
/obj/crawler/crawler_wallbreaker,
/turf/simulated/wall/untinted/onestar_reinforced,
/area/crawler)
"j" = (
/turf/simulated/floor/tiled/derelict,
/area/crawler)
"k" = (
/obj/structure/window/reinforced,
/obj/structure/salvageable/console_os{
	dir = 4
	},
/turf/simulated/floor/tiled/cafe,
/area/crawler)
"l" = (
/obj/machinery/door/window/southright,
/turf/simulated/floor/tiled/cafe,
/area/crawler)
"m" = (
/obj/structure/table/onestar,
/obj/random/medical_lowcost,
/obj/random/medical_lowcost,
/turf/simulated/floor/tiled/cafe,
/area/crawler)
"n" = (
/obj/machinery/door/window/southleft,
/turf/simulated/floor/tiled/cafe,
/area/crawler)
"o" = (
/obj/structure/table/onestar,
/obj/random/surgery_tool,
/obj/random/surgery_tool,
/obj/random/surgery_tool,
/obj/structure/window/reinforced,
/turf/simulated/floor/tiled/cafe,
/area/crawler)
"p" = (
/obj/effect/floor_decal/industrial/outline,
/obj/structure/medical_stand,
/turf/simulated/floor/tiled/derelict,
/area/crawler)
"s" = (
/obj/effect/floor_decal/industrial/outline,
/turf/simulated/floor/tiled/derelict,
/area/crawler)
"t" = (
/obj/machinery/door/airlock/freezer,
/turf/simulated/floor/tiled/techmaint,
/area/crawler)
"u" = (
/obj/effect/floor_decal/industrial/danger{
	dir = 8
	},
/turf/simulated/floor/tiled/derelict,
/area/crawler)
"v" = (
/obj/effect/floor_decal/industrial/danger{
	dir = 4
	},
/turf/simulated/floor/tiled/derelict,
/area/crawler)
"w" = (
/obj/effect/floor_decal/industrial/outline,
/obj/structure/table/rack,
/turf/simulated/floor/tiled/derelict,
/area/crawler)
"x" = (
/obj/random/mob/roomba,
/turf/simulated/floor/tiled/derelict,
/area/crawler)
"y" = (
/obj/effect/window_lwall_spawn/smartspawn/onestar,
/turf/simulated/floor/tiled/derelict/white_small_edges,
/area/crawler)
"z" = (
/obj/structure/table/onestar,
/obj/random/medical_lowcost,
/obj/structure/window/reinforced,
/turf/simulated/floor/tiled/cafe,
/area/crawler)
"A" = (
/obj/machinery/door/window/northright,
/turf/simulated/floor/tiled/cafe,
/area/crawler)
"B" = (
/obj/structure/window/reinforced,
/obj/structure/salvageable/console_os{
	dir = 8
	},
/turf/simulated/floor/tiled/cafe,
/area/crawler)
"C" = (
/obj/machinery/washing_machine,
/obj/structure/window/reinforced{
	dir = 1;
	pixel_y = 0
	},
/turf/simulated/floor/tiled/cafe,
/area/crawler)
"D" = (
/obj/machinery/door/window/northleft,
/turf/simulated/floor/tiled/cafe,
/area/crawler)
"E" = (
/obj/effect/floor_decal/industrial/outline,
/obj/structure/table/rack,
/obj/random/firstaid,
/obj/random/firstaid,
/obj/random/firstaid,
/turf/simulated/floor/tiled/derelict,
/area/crawler)
"F" = (
/obj/structure/table/onestar,
/obj/random/medical_lowcost,
/obj/structure/window/reinforced{
	dir = 1;
	pixel_y = 0
	},
/turf/simulated/floor/tiled/cafe,
/area/crawler)
"G" = (
/obj/structure/table/onestar,
/obj/random/medical_lowcost,
/obj/random/medical_lowcost,
/obj/structure/window/reinforced{
	dir = 1
	},
/turf/simulated/floor/tiled/cafe,
/area/crawler)
"H" = (
/obj/structure/table/onestar,
/obj/random/surgery_tool,
/obj/random/surgery_tool,
/turf/simulated/floor/tiled/cafe,
/area/crawler)
"I" = (
/obj/structure/table/onestar,
/obj/random/surgery_tool,
/obj/random/surgery_tool,
/obj/random/medical_lowcost,
/turf/simulated/floor/tiled/cafe,
/area/crawler)
"J" = (
/obj/machinery/washing_machine,
/obj/structure/window/reinforced{
	dir = 1
	},
/turf/simulated/floor/tiled/cafe,
/area/crawler)

(1,1,1) = {"
a
a
a
a
a
f
a
a
a
"}
(2,1,1) = {"
a
d
k
p
s
w
C
c
a
"}
(3,1,1) = {"
a
c
l
j
j
j
A
c
a
"}
(4,1,1) = {"
a
h
o
j
j
j
F
H
a
"}
(5,1,1) = {"
a
e
e
a
t
a
y
y
i
"}
(6,1,1) = {"
i
j
j
u
u
u
j
j
i
"}
(7,1,1) = {"
i
j
x
x
j
x
j
x
i
"}
(8,1,1) = {"
i
j
j
v
v
v
j
j
i
"}
(9,1,1) = {"
a
e
e
a
t
a
y
y
i
"}
(10,1,1) = {"
a
m
z
j
j
j
G
I
a
"}
(11,1,1) = {"
a
c
n
j
j
j
D
c
a
"}
(12,1,1) = {"
a
d
B
p
s
E
J
c
a
"}
(13,1,1) = {"
a
a
f
f
f
f
f
a
a
"}
