//MAP CONVERTED BY dmm2tgm.py THIS HEADER COMMENT PREVENTS RECONVERSION, DO NOT REMOVE
"aa" = (
/turf/template_noop,
/area/template_noop)
"ab" = (
/obj/structure/lattice,
/turf/template_noop,
/area/template_noop)
"ac" = (
/obj/structure/railing,
/turf/template_noop,
/area/template_noop)
"ad" = (
/obj/effect/window_lwall_spawn/smartspawn,
/turf/simulated/floor/plating,
/area/template_noop)
"ae" = (
/obj/random/scrap/sparse_even/low_chance,
/turf/simulated/floor/plating/under,
/area/template_noop)
"af" = (
/obj/random/mob/carp,
/turf/simulated/floor/plating/under,
/area/template_noop)
"ag" = (
/obj/machinery/door/airlock/maintenance_common{
	name = "Service Maintenance";
	req_access = list(12)
	},
/turf/simulated/floor/tiled/techmaint_cargo,
/area/template_noop)
"ah" = (
/obj/effect/decal/cleanable/dirt,
/turf/simulated/floor/plating/under,
/area/template_noop)
"ai" = (
/obj/random/junk/low_chance,
/turf/simulated/floor/plating/under,
/area/template_noop)
"aj" = (
/obj/machinery/light/small,
/turf/simulated/floor/plating/under,
/area/template_noop)
"ak" = (
/turf/simulated/wall/r_wall,
/area/template_noop)
"al" = (
/obj/random/techpart/low_chance,
/obj/random/junkfood/rotten,
/obj/random/junkfood/rotten,
/obj/random/junkfood/rotten,
/obj/random/junk/low_chance,
/turf/simulated/floor/tiled/techmaint,
/area/template_noop)
"am" = (
/turf/simulated/floor/tiled/techmaint,
/area/template_noop)
"an" = (
/turf/simulated/wall,
/area/template_noop)
"ao" = (
/obj/structure/scrap/poor/large,
/turf/simulated/floor/plating/under,
/area/template_noop)
"aq" = (
/obj/random/techpart/low_chance,
/turf/simulated/floor/plating/under,
/area/template_noop)
"ar" = (
/obj/random/mob/carp,
/turf/template_noop,
/area/template_noop)
"as" = (
/mob/living/simple_animal/hostile/carp/baby,
/turf/simulated/floor/tiled/techmaint,
/area/template_noop)
"at" = (
/obj/structure/railing{
	dir = 4;
	tag = "icon-railing0 (EAST)"
	},
/turf/template_noop,
/area/template_noop)
"au" = (
/obj/structure/railing{
	dir = 4;
	tag = "icon-railing0 (EAST)"
	},
/obj/structure/railing,
/turf/template_noop,
/area/template_noop)
"av" = (
/obj/random/pack/tech_loot/low_chance,
/obj/random/pack/tech_loot/low_chance,
/turf/simulated/floor/plating/under,
/area/template_noop)
"aw" = (
/obj/random/booze/low_chance,
/obj/random/booze/low_chance,
/turf/simulated/floor/plating/under,
/area/template_noop)
"ax" = (
/turf/simulated/floor/tiled/techmaint_panels,
/area/template_noop)
"ay" = (
/obj/machinery/light/small,
/obj/structure/scrap/poor/large,
/turf/simulated/floor/tiled/techmaint,
/area/template_noop)
"az" = (
/obj/random/traps,
/turf/simulated/floor/tiled/techmaint,
/area/template_noop)
"aA" = (
/obj/structure/lattice,
/obj/structure/scrap_cube,
/turf/template_noop,
/area/template_noop)
"aB" = (
/obj/structure/scrap/poor/large,
/turf/simulated/floor/tiled/techmaint,
/area/template_noop)
"aC" = (
/obj/structure/table/rack,
/obj/random/contraband/low_chance,
/obj/random/tank,
/obj/random/tank,
/turf/simulated/floor/plating/under,
/area/template_noop)
"aD" = (
/turf/simulated/floor/plating/under,
/area/template_noop)
"aE" = (
/obj/random/scrap/sparse_even/low_chance,
/obj/structure/scrap/poor/large,
/turf/simulated/floor/tiled/techmaint,
/area/template_noop)
"aF" = (
/obj/random/lowkeyrandom/low_chance,
/turf/simulated/floor/tiled/steel,
/area/template_noop)
"aG" = (
/obj/machinery/light/small{
	dir = 8
	},
/turf/simulated/floor/plating/under,
/area/template_noop)
"aH" = (
/obj/machinery/light/small{
	dir = 1
	},
/turf/simulated/floor/plating/under,
/area/template_noop)
"aI" = (
/obj/structure/table/rack,
/obj/random/pack/tech_loot,
/obj/random/pack/tech_loot,
/obj/random/pack/tech_loot,
/obj/random/pack/tech_loot,
/turf/simulated/floor/tiled/techmaint_panels,
/area/template_noop)
"aJ" = (
/obj/random/junk/low_chance,
/obj/machinery/light/small,
/turf/simulated/floor/plating/under,
/area/template_noop)
"aK" = (
/obj/structure/table/rack/shelf,
/obj/random/lowkeyrandom/low_chance,
/obj/random/lowkeyrandom/low_chance,
/obj/random/pack/tech_loot/low_chance,
/obj/random/pack/tech_loot/low_chance,
/turf/simulated/floor/tiled/techmaint,
/area/template_noop)
"aL" = (
/obj/machinery/light/small{
	dir = 1
	},
/obj/structure/scrap/poor/large,
/turf/simulated/floor/plating/under,
/area/template_noop)
"aM" = (
/obj/structure/catwalk,
/obj/structure/cable/green{
	d1 = 2;
	d2 = 4;
	icon_state = "2-4"
	},
/turf/simulated/floor/plating/under,
/area/template_noop)
"aN" = (
/obj/machinery/door/firedoor,
/obj/machinery/door/airlock/maintenance_medical{
	name = "Chemistry Maintenance";
	req_access = list(33)
	},
/obj/machinery/door/blast/regular{
	density = 0;
	icon_state = "pdoor0";
	id = "MedbayTotalLockdown";
	layer = 2.6;
	name = "Medbay Total Lockdown";
	opacity = 0
	},
/obj/structure/cable/green{
	d1 = 4;
	d2 = 8;
	icon_state = "4-8"
	},
/turf/simulated/floor/tiled/techmaint_cargo,
/area/template_noop)
"aO" = (
/obj/structure/railing{
	dir = 1;
	tag = "icon-railing0 (NORTH)"
	},
/turf/template_noop,
/area/template_noop)
"aP" = (
/obj/structure/cable/green{
	d1 = 2;
	d2 = 4;
	icon_state = "2-4"
	},
/obj/structure/catwalk,
/turf/simulated/floor/plating/under,
/area/template_noop)
"aQ" = (
/obj/machinery/door/airlock/maintenance_common{
	name = "Service Maintenance";
	req_access = list(12)
	},
/obj/structure/cable/green{
	d1 = 4;
	d2 = 8;
	icon_state = "4-8"
	},
/turf/simulated/floor/tiled/techmaint_cargo,
/area/template_noop)
"aR" = (
/obj/random/scrap/sparse_even/low_chance,
/turf/simulated/floor/tiled/techmaint,
/area/template_noop)
"aS" = (
/obj/machinery/light/small{
	dir = 1
	},
/obj/structure/cable/green{
	d1 = 4;
	d2 = 8;
	icon_state = "4-8"
	},
/obj/structure/catwalk,
/turf/simulated/floor/plating/under,
/area/template_noop)
"aT" = (
/obj/random/junk/low_chance,
/obj/structure/catwalk,
/obj/structure/cable/green{
	d1 = 1;
	d2 = 8;
	icon_state = "1-8"
	},
/turf/simulated/floor/plating/under,
/area/template_noop)
"aU" = (
/obj/random/junk/low_chance,
/turf/simulated/floor/tiled/techmaint,
/area/template_noop)
"aV" = (
/obj/random/junk/low_chance,
/turf/simulated/floor/tiled/steel,
/area/template_noop)
"aW" = (
/obj/machinery/light/small{
	dir = 1
	},
/obj/structure/cable/green{
	d2 = 4;
	icon_state = "0-4"
	},
/obj/structure/catwalk,
/turf/simulated/floor/plating/under,
/area/template_noop)
"aX" = (
/obj/structure/girder,
/turf/simulated/floor/plating/under,
/area/template_noop)
"aY" = (
/mob/living/simple_animal/hostile/carp/baby,
/turf/simulated/floor/plating/under,
/area/template_noop)
"aZ" = (
/obj/random/junk/low_chance,
/obj/structure/cable/green{
	d1 = 1;
	d2 = 2;
	icon_state = "1-2"
	},
/obj/structure/catwalk,
/turf/simulated/floor/plating/under,
/area/template_noop)
"ba" = (
/obj/structure/table/rack,
/obj/random/pack/tech_loot,
/obj/random/boxes,
/turf/simulated/floor/tiled/steel/gray_platform,
/area/template_noop)
"bb" = (
/obj/random/mob/carp,
/turf/simulated/floor/tiled/steel,
/area/template_noop)
"bc" = (
/obj/structure/scrap/poor/large,
/turf/simulated/floor/tiled/steel/gray_platform,
/area/template_noop)
"bd" = (
/obj/random/scrap/sparse_even/low_chance,
/turf/simulated/floor/tiled/techmaint_panels,
/area/template_noop)
"be" = (
/obj/structure/cable/green{
	d1 = 1;
	d2 = 8;
	icon_state = "1-8"
	},
/obj/structure/catwalk,
/obj/random/mob/carp,
/turf/simulated/floor/plating/under,
/area/template_noop)
"bf" = (
/obj/structure/table/rack,
/obj/random/pack/tech_loot,
/obj/random/pack/tech_loot,
/obj/random/boxes,
/turf/simulated/floor/plating/under,
/area/template_noop)
"bg" = (
/turf/simulated/floor/tiled/steel/gray_platform,
/area/template_noop)
"bh" = (
/obj/random/pack/tech_loot,
/obj/random/pack/tech_loot,
/obj/structure/table/rack,
/turf/simulated/floor/plating/under,
/area/template_noop)
"bi" = (
/obj/machinery/door/firedoor,
/obj/effect/window_lwall_spawn/smartspawn,
/turf/simulated/floor/plating,
/area/template_noop)
"bj" = (
/obj/structure/table/standard,
/obj/random/pack/tech_loot,
/obj/random/pack/tech_loot,
/turf/simulated/floor/tiled/steel/gray_platform,
/area/template_noop)
"bk" = (
/obj/structure/cable/green{
	d1 = 4;
	d2 = 8;
	icon_state = "4-8"
	},
/obj/structure/catwalk,
/mob/living/simple_animal/hostile/carp/baby,
/turf/simulated/floor/plating/under,
/area/template_noop)
"bl" = (
/obj/random/mob/carp,
/turf/simulated/floor/tiled/techmaint,
/area/template_noop)
"da" = (
/obj/random/junk/low_chance,
/turf/template_noop,
/area/template_noop)
"dn" = (
/obj/structure/lattice,
/obj/random/lowkeyrandom/low_chance,
/turf/template_noop,
/area/template_noop)
"pF" = (
/obj/random/structures/low_chance,
/turf/template_noop,
/area/template_noop)
"rE" = (
/obj/random/lowkeyrandom/low_chance,
/turf/template_noop,
/area/template_noop)
"tL" = (
/obj/effect/decal/cleanable/blood/oil,
/turf/simulated/floor/plating/under,
/area/template_noop)
"Bx" = (
/obj/effect/decal/cleanable/dirt,
/obj/structure/scrap/poor/large,
/turf/simulated/floor/plating/under,
/area/template_noop)
"HT" = (
/obj/structure/lattice,
/obj/random/junk/low_chance,
/turf/template_noop,
/area/template_noop)
"LF" = (
/obj/random/lowkeyrandom/low_chance,
/turf/simulated/floor/plating/under,
/area/template_noop)
"LP" = (
/obj/random/mob/carp,
/turf/simulated/floor/tiled/techmaint_panels,
/area/template_noop)
"RB" = (
/obj/random/lowkeyrandom/low_chance,
/turf/simulated/floor/tiled/techmaint,
/area/template_noop)

(1,1,1) = {"
aa
rE
aa
aa
ab
af
aa
aa
aa
aa
aa
aa
aa
aa
ab
ab
ab
ab
aa
aa
aa
ab
ab
aD
ab
"}
(2,1,1) = {"
aa
aa
ab
ae
aX
aX
aa
aa
aa
aa
aa
da
aa
aa
aa
ak
ak
aX
aX
aa
aa
aX
ak
aX
ab
"}
(3,1,1) = {"
da
aa
pF
aa
ao
ab
ab
aa
da
pF
aa
aa
aa
aa
aa
aX
aD
aU
ak
ab
ab
aU
tL
aX
aa
"}
(4,1,1) = {"
aa
aa
aa
ab
ab
aa
aa
aa
aa
rE
aa
ar
aa
pF
aa
dn
ae
ax
ak
da
ab
bl
aD
ab
aa
"}
(5,1,1) = {"
aa
aa
aa
dn
ab
pF
da
aa
aa
aa
aa
aa
aa
aa
aa
ab
aD
bl
ak
aa
ab
ab
aa
aa
aa
"}
(6,1,1) = {"
aa
aa
HT
ab
ab
ar
aa
aa
da
aa
aX
aH
ai
aX
aa
aX
ak
ag
ak
ak
aX
ab
aa
aa
aa
"}
(7,1,1) = {"
aa
ab
ab
aa
ab
dn
aa
aa
aa
aa
aX
ai
aD
ak
ab
aa
ak
aV
ba
bf
dn
aa
aa
da
aa
"}
(8,1,1) = {"
aX
aX
ad
ak
ak
ab
ab
aX
ab
aa
ak
aD
af
ak
ab
HT
ak
aV
aD
aD
ab
ab
ab
aa
aa
"}
(9,1,1) = {"
aa
ab
aq
al
ak
ak
ak
aX
ab
ab
an
ae
aJ
aX
ab
ab
ak
aF
bb
aD
ae
aX
ab
aa
aa
"}
(10,1,1) = {"
aa
ab
af
RB
am
aB
aD
aD
aD
aX
ak
ai
aD
ab
aa
ab
ak
bc
bc
bg
bj
aX
ab
aa
aa
"}
(11,1,1) = {"
aa
aX
ag
an
an
an
an
an
an
ak
aD
aD
ab
ai
aX
ak
ak
an
ad
ad
an
aX
aa
aa
aa
"}
(12,1,1) = {"
aa
aa
ab
ab
aa
da
aa
ac
ay
ak
aH
ab
dn
aj
ak
aL
aO
aa
aa
aa
aa
aa
aa
aa
aa
"}
(13,1,1) = {"
aa
aa
ab
aa
aa
at
at
au
az
ag
aD
aA
ab
aD
ag
aD
aO
da
aa
aa
aa
aa
aa
aa
aa
"}
(14,1,1) = {"
da
ac
Bx
aD
aD
aD
am
RB
am
ak
ai
aY
aD
ai
an
aX
aa
aa
ai
LF
aa
aa
da
aa
aa
"}
(15,1,1) = {"
aa
ac
aD
an
an
an
an
an
ag
ak
aB
aI
aI
ai
ab
aa
aa
aX
as
aD
aO
aa
aa
aa
aa
"}
(16,1,1) = {"
aa
ac
ae
an
aq
aq
an
ao
aD
an
an
an
aX
aa
aa
aa
ab
an
aW
bh
aO
aa
aa
aa
aa
"}
(17,1,1) = {"
aa
aa
aD
ad
aD
ae
an
av
ab
ao
an
ab
aa
ao
aa
aa
aX
an
aQ
aX
aX
aX
rE
aa
aa
"}
(18,1,1) = {"
aa
aa
af
ad
aa
aa
an
aw
ab
aC
an
rE
aa
aa
ab
aX
aP
aZ
be
ak
ab
ab
aa
aa
aa
"}
(19,1,1) = {"
aa
aa
ai
an
aa
aa
an
an
an
an
aX
aa
da
ab
ao
an
aQ
ad
ak
ak
ab
ab
ab
da
aa
"}
(20,1,1) = {"
aa
aa
ah
ag
ab
ab
ag
as
RB
aR
aG
ab
aa
aD
ao
an
bk
aO
aa
ak
aa
aa
aa
aa
aa
"}
(21,1,1) = {"
aa
aa
aj
an
aa
ab
aX
ax
aB
as
aD
ab
ab
aD
bd
an
aS
aO
aa
bi
da
aa
ab
aa
aa
"}
(22,1,1) = {"
aa
aa
aD
ad
ar
da
an
an
an
an
ag
an
LP
am
aK
aX
ab
da
aa
bi
ab
aa
ab
aa
aa
"}
(23,1,1) = {"
aa
aa
ab
ad
aa
ab
ab
an
aE
am
aD
an
an
an
an
aX
ab
aa
aa
aX
aa
ab
aX
ab
aa
"}
(24,1,1) = {"
da
ab
ab
an
ab
ab
an
an
an
an
ai
aG
aD
ao
aD
aM
aT
rE
aa
aX
ab
af
aX
aX
ab
"}
(25,1,1) = {"
aa
ab
aD
aX
aX
aX
an
ab
ab
an
ab
ab
ab
an
an
aN
aX
aa
aa
aa
ab
ab
aD
ab
aa
"}
