"aa" = (/turf/template_noop,/area/template_noop)
"ab" = (/obj/structure/lattice,/turf/template_noop,/area/template_noop)
"ac" = (/obj/structure/railing,/turf/template_noop,/area/template_noop)
"ad" = (/obj/effect/window_lwall_spawn/smartspawn,/turf/simulated/floor/plating,/area/template_noop)
"ae" = (/obj/random/scrap/sparse_even/low_chance,/turf/simulated/floor/plating/under,/area/template_noop)
"af" = (/obj/random/mob/carp,/turf/simulated/floor/plating/under,/area/template_noop)
"ag" = (/obj/machinery/door/airlock/maintenance_common{name = "Service Maintenance"; req_access = list(12)},/turf/simulated/floor/tiled/techmaint_cargo,/area/template_noop)
"ah" = (/obj/effect/decal/cleanable/dirt,/turf/simulated/floor/plating/under,/area/template_noop)
"ai" = (/obj/random/junk/low_chance,/turf/simulated/floor/plating/under,/area/template_noop)
"aj" = (/obj/machinery/light/small,/turf/simulated/floor/plating/under,/area/template_noop)
"ak" = (/turf/simulated/wall/r_wall,/area/template_noop)
"al" = (/obj/random/techpart/low_chance,/obj/random/junkfood/rotten,/obj/random/junkfood/rotten,/obj/random/junkfood/rotten,/obj/random/junk/low_chance,/turf/simulated/floor/tiled/techmaint,/area/template_noop)
"am" = (/turf/simulated/floor/tiled/techmaint,/area/template_noop)
"an" = (/turf/simulated/wall,/area/template_noop)
"ao" = (/obj/structure/scrap/poor/large,/turf/simulated/floor/plating/under,/area/template_noop)
"aq" = (/obj/random/techpart/low_chance,/turf/simulated/floor/plating/under,/area/template_noop)
"ar" = (/obj/random/mob/carp,/turf/template_noop,/area/template_noop)
"as" = (/mob/living/simple_animal/hostile/carp/baby,/turf/simulated/floor/tiled/techmaint,/area/template_noop)
"at" = (/obj/structure/railing{dir = 4; tag = "icon-railing0 (EAST)"},/turf/template_noop,/area/template_noop)
"au" = (/obj/structure/railing{dir = 4; tag = "icon-railing0 (EAST)"},/obj/structure/railing,/turf/template_noop,/area/template_noop)
"av" = (/obj/random/pack/tech_loot/low_chance,/obj/random/pack/tech_loot/low_chance,/turf/simulated/floor/plating/under,/area/template_noop)
"aw" = (/obj/random/booze/low_chance,/obj/random/booze/low_chance,/turf/simulated/floor/plating/under,/area/template_noop)
"ax" = (/turf/simulated/floor/tiled/techmaint_panels,/area/template_noop)
"ay" = (/obj/machinery/light/small,/obj/structure/scrap/poor/large,/turf/simulated/floor/tiled/techmaint,/area/template_noop)
"az" = (/obj/random/traps,/turf/simulated/floor/tiled/techmaint,/area/template_noop)
"aA" = (/mob/living/simple_animal/hostile/bear,/turf/simulated/floor/plating/under,/area/template_noop)
"aB" = (/obj/structure/scrap/poor/large,/turf/simulated/floor/tiled/techmaint,/area/template_noop)
"aC" = (/obj/structure/table/rack,/obj/random/contraband/low_chance,/obj/random/tank,/obj/random/tank,/turf/simulated/floor/plating/under,/area/template_noop)
"aD" = (/turf/simulated/floor/plating/under,/area/template_noop)
"aE" = (/obj/random/scrap/sparse_even/low_chance,/obj/structure/scrap/poor/large,/turf/simulated/floor/tiled/techmaint,/area/template_noop)
"aF" = (/turf/simulated/floor/tiled/steel,/area/template_noop)
"aG" = (/obj/machinery/light/small{dir = 8},/turf/simulated/floor/plating/under,/area/template_noop)
"aH" = (/obj/machinery/light/small{dir = 1},/turf/simulated/floor/plating/under,/area/template_noop)
"aI" = (/obj/structure/table/rack,/obj/random/pack/tech_loot,/obj/random/pack/tech_loot,/obj/random/pack/tech_loot,/obj/random/pack/tech_loot,/turf/simulated/floor/tiled/techmaint_panels,/area/template_noop)
"aJ" = (/obj/random/junk/low_chance,/obj/machinery/light/small,/turf/simulated/floor/plating/under,/area/template_noop)
"aK" = (/obj/structure/table/rack/shelf,/obj/random/lowkeyrandom/low_chance,/obj/random/lowkeyrandom/low_chance,/obj/random/pack/tech_loot/low_chance,/obj/random/pack/tech_loot/low_chance,/turf/simulated/floor/tiled/techmaint,/area/template_noop)
"aL" = (/obj/machinery/light/small{dir = 1},/obj/structure/scrap/poor/large,/turf/simulated/floor/plating/under,/area/template_noop)
"aM" = (/obj/structure/catwalk,/obj/structure/cable/green{d1 = 2; d2 = 4; icon_state = "2-4"},/turf/simulated/floor/plating/under,/area/template_noop)
"aN" = (/obj/machinery/door/firedoor,/obj/machinery/door/airlock/maintenance_medical{name = "Chemistry Maintenance"; req_access = list(33)},/obj/machinery/door/blast/regular{density = 0; icon_state = "pdoor0"; id = "MedbayTotalLockdown"; layer = 2.6; name = "Medbay Total Lockdown"; opacity = 0},/obj/structure/cable/green{d1 = 4; d2 = 8; icon_state = "4-8"},/turf/simulated/floor/tiled/techmaint_cargo,/area/template_noop)
"aO" = (/obj/structure/railing{dir = 1; tag = "icon-railing0 (NORTH)"},/turf/template_noop,/area/template_noop)
"aP" = (/obj/structure/cable/green{d1 = 2; d2 = 4; icon_state = "2-4"},/obj/structure/catwalk,/turf/simulated/floor/plating/under,/area/template_noop)
"aQ" = (/obj/machinery/door/airlock/maintenance_common{name = "Service Maintenance"; req_access = list(12)},/obj/structure/cable/green{d1 = 4; d2 = 8; icon_state = "4-8"},/turf/simulated/floor/tiled/techmaint_cargo,/area/template_noop)
"aR" = (/obj/random/scrap/sparse_even/low_chance,/turf/simulated/floor/tiled/techmaint,/area/template_noop)
"aS" = (/obj/machinery/light/small{dir = 1},/obj/structure/cable/green{d1 = 4; d2 = 8; icon_state = "4-8"},/obj/structure/catwalk,/turf/simulated/floor/plating/under,/area/template_noop)
"aT" = (/obj/random/junk/low_chance,/obj/structure/catwalk,/obj/structure/cable/green{d1 = 1; d2 = 8; icon_state = "1-8"},/turf/simulated/floor/plating/under,/area/template_noop)
"aU" = (/obj/random/junk/low_chance,/turf/simulated/floor/tiled/techmaint,/area/template_noop)
"aV" = (/obj/random/junk/low_chance,/turf/simulated/floor/tiled/steel,/area/template_noop)
"aW" = (/obj/machinery/light/small{dir = 1},/obj/structure/cable/green{d2 = 4; icon_state = "0-4"},/obj/structure/catwalk,/turf/simulated/floor/plating/under,/area/template_noop)
"aX" = (/obj/structure/girder,/turf/simulated/floor/plating/under,/area/template_noop)
"aY" = (/mob/living/simple_animal/hostile/carp/baby,/turf/simulated/floor/plating/under,/area/template_noop)
"aZ" = (/obj/random/junk/low_chance,/obj/structure/cable/green{d1 = 1; d2 = 2; icon_state = "1-2"},/obj/structure/catwalk,/turf/simulated/floor/plating/under,/area/template_noop)
"ba" = (/obj/structure/table/rack,/obj/random/pack/tech_loot,/obj/random/boxes,/turf/simulated/floor/tiled/steel/gray_platform,/area/template_noop)
"bb" = (/obj/random/mob/carp,/turf/simulated/floor/tiled/steel,/area/template_noop)
"bc" = (/obj/structure/scrap/poor/large,/turf/simulated/floor/tiled/steel/gray_platform,/area/template_noop)
"bd" = (/obj/random/scrap/sparse_even/low_chance,/turf/simulated/floor/tiled/techmaint_panels,/area/template_noop)
"be" = (/obj/structure/cable/green{d1 = 1; d2 = 8; icon_state = "1-8"},/obj/structure/catwalk,/obj/random/mob/carp,/turf/simulated/floor/plating/under,/area/template_noop)
"bf" = (/obj/structure/table/rack,/obj/random/pack/tech_loot,/obj/random/pack/tech_loot,/obj/random/boxes,/turf/simulated/floor/plating/under,/area/template_noop)
"bg" = (/turf/simulated/floor/tiled/steel/gray_platform,/area/template_noop)
"bh" = (/obj/random/pack/tech_loot,/obj/random/pack/tech_loot,/obj/structure/table/rack,/turf/simulated/floor/plating/under,/area/template_noop)
"bi" = (/obj/machinery/door/firedoor,/obj/effect/window_lwall_spawn/smartspawn,/turf/simulated/floor/plating,/area/template_noop)
"bj" = (/obj/structure/table/standard,/obj/item/weapon/folder/blue,/obj/item/weapon/hand_labeler,/obj/random/pack/tech_loot,/obj/random/pack/tech_loot,/turf/simulated/floor/tiled/steel/gray_platform,/area/template_noop)
"bk" = (/obj/structure/cable/green{d1 = 4; d2 = 8; icon_state = "4-8"},/obj/structure/catwalk,/mob/living/simple_animal/hostile/carp/baby,/turf/simulated/floor/plating/under,/area/template_noop)
"bl" = (/obj/random/mob/carp,/turf/simulated/floor/tiled/techmaint,/area/template_noop)
"da" = (/obj/random/junk/low_chance,/turf/template_noop,/area/template_noop)
"tL" = (/obj/effect/decal/cleanable/blood/oil,/turf/simulated/floor/plating/under,/area/template_noop)
"Bx" = (/obj/effect/decal/cleanable/dirt,/obj/structure/scrap/poor/large,/turf/simulated/floor/plating/under,/area/template_noop)
"HT" = (/obj/structure/lattice,/obj/random/junk/low_chance,/turf/template_noop,/area/template_noop)
"LP" = (/obj/random/mob/carp,/turf/simulated/floor/tiled/techmaint_panels,/area/template_noop)
"Zk" = (/obj/structure/lattice,/obj/structure/scrap_cube,/turf/template_noop,/area/template_noop)

(1,1,1) = {"
aaaadaaaaaaaaaaXaaaaaaaaaadaaaaaaaaaaaaaaaaaaadaaa
aaaaaaaaaaaaabaXababaXaaaaacacacaaaaaaaaaaaaaaabab
aaabaaaaaaHTabadaqafagababBxaDaeaDafaiahajaDababaD
aaaeaaabababaaakalamanabaaaDananadadanaganadadanaX
abaXaoababababakakamanaaaaaDanaqaDaaaaabaaaraaabaX
afaXabaaaaaaababakaBandaataDanaqaeaaaaababdaababaX
aaaaabaadaaaaaabakaDanaaatamanananananagaXanabanan
aaaaaaaaaaaaaaaXaXaDanacauamanaoavawanasaxanananab
aaaadaaaaadaaaababaDanayazamagaAababanamaBanaEanab
aaaaaaaaaaaaaaaaabaXakakagakakanaoaCanaRasanamanan
aaaaaaaaaaaXaXakanakaDaHaDaiaBanananaXaGaDagaDaiab
aadaaaaaaaaHaiaDaeaiaDZkabaYaIanabaaaaababananaGab
aaaaaaaaaaaiaDafaJaDabababaDaIaXaaaadaaaabLPanaDab
aaaaaaaaaaaXakakaXabaiajaDaiaiaaaoaaabaDaDamanaoan
abaaaaaaaaaaabababaaaXakaganabaaaaabaoaobdaKanaDan
abakaXababaXaaHTababakaLaDaXaaaaaaaXanananaXaXaMaN
abakaDaeaDakakakakakakaOaOaaaaabaXaPaQbkaSababaTaX
abaXaUaxblagaVaVaFbcanaadaaaaXananaZadaOaOdaaaaaaa
aaaXakakakakbaaDbbbcadaaaaaiasaWaQbeakaaaaaaaaaaaa
aaaaabdaaaakbfaDaDbgadaaaaaDaDbhaXakakakbibiaXaXaa
aaaaabababaXababaebjanaaaaaaaOaOaXababaadaabaaabab
abaXaUblababaaabaXaXaXaaaaaaaaaaaXababaaaaaaabafab
abaktLaDaaaaaaabababaaaaaadaaaaaaaaaabaaababaXaXaD
aDaXaXabaaaadaaaaaaaaaaaaaaaaaaaaaaadaaaaaaaabaXab
ababaaaaaaaaaaaaaaaaaaaaaaaaaaaaaaaaaaaaaaaaaaabaa
"}
