"aa" = (/obj/structure/lattice,/obj/structure/lattice,/turf/template_noop,/area/template_noop)
"ab" = (/obj/structure/lattice,/turf/template_noop,/area/template_noop)
"ac" = (/obj/random/mob/carp,/turf/simulated/floor/tiled/steel/cargo,/area/template_noop)
"ad" = (/turf/simulated/wall/r_wall,/area/template_noop)
"ae" = (/obj/effect/window_lwall_spawn/smartspawn,/turf/simulated/floor/plating,/area/template_noop)
"af" = (/obj/random/mob/carp,/turf/simulated/floor/plating/under,/area/template_noop)
"ag" = (/obj/structure/girder,/turf/simulated/floor/plating/under,/area/template_noop)
"ah" = (/obj/random/scrap/dense_weighted,/turf/simulated/floor/plating,/area/template_noop)
"ai" = (/obj/machinery/door/airlock/maintenance_common{name = "Service Maintenance"; req_access = list(12)},/turf/simulated/floor/tiled/techmaint_cargo,/area/template_noop)
"aj" = (/obj/random/scrap/dense_weighted,/turf/simulated/floor/tiled/techmaint,/area/template_noop)
"ak" = (/obj/random/pack/tech_loot/low_chance,/turf/simulated/floor/tiled/techmaint,/area/template_noop)
"al" = (/obj/machinery/light/small,/turf/simulated/floor/tiled/techmaint,/area/template_noop)
"am" = (/obj/random/closet_maintloot/low_chance,/turf/simulated/floor/plating/under,/area/template_noop)
"an" = (/obj/structure/closet/emcloset,/turf/simulated/floor/tiled/techmaint_perforated,/area/template_noop)
"ao" = (/obj/random/closet_maintloot,/turf/simulated/floor/plating/under,/area/template_noop)
"ap" = (/obj/machinery/door/airlock/maintenance_interior{name = "Reserve Storage"; req_access = list(12)},/turf/simulated/floor/tiled/techmaint_cargo,/area/template_noop)
"aq" = (/obj/structure/catwalk,/obj/structure/cable/green{d2 = 2; icon_state = "0-2"},/turf/simulated/floor/plating/under,/area/template_noop)
"ar" = (/obj/random/pack/junk_machine/beacon,/turf/simulated/floor/plating/under,/area/template_noop)
"as" = (/obj/random/junk,/turf/simulated/floor/plating/under,/area/template_noop)
"at" = (/turf/simulated/wall,/area/template_noop)
"au" = (/obj/machinery/light/small{dir = 8},/turf/simulated/floor/tiled/techmaint,/area/template_noop)
"av" = (/obj/random/pack/machine/low_chance,/turf/simulated/floor/tiled/techmaint,/area/template_noop)
"aw" = (/mob/living/simple_animal/hostile/carp/pike,/turf/simulated/floor/tiled/techmaint,/area/template_noop)
"ax" = (/obj/random/scrap/dense_weighted,/turf/simulated/floor/plating/under,/area/template_noop)
"ay" = (/obj/machinery/light{dir = 4},/obj/random/scrap/dense_weighted,/turf/simulated/floor/plating/under,/area/template_noop)
"az" = (/obj/machinery/atmospherics/pipe/simple/hidden,/turf/simulated/wall,/area/template_noop)
"aA" = (/obj/machinery/light/small{dir = 4},/obj/random/junk,/turf/simulated/floor/tiled/techmaint,/area/template_noop)
"aB" = (/obj/random/junk,/turf/simulated/floor/tiled/techmaint,/area/template_noop)
"aC" = (/obj/structure/table/rack,/obj/random/pack/gun_loot/low_chance,/obj/random/pack/rare/low_chance,/turf/simulated/floor/tiled/techmaint,/area/template_noop)
"aD" = (/obj/structure/table/rack,/turf/simulated/floor/tiled/techmaint,/area/template_noop)
"aE" = (/turf/simulated/floor/tiled/steel/gray_perforated,/area/template_noop)
"aF" = (/obj/structure/catwalk,/turf/template_noop,/area/template_noop)
"aG" = (/turf/simulated/floor/tiled/techmaint,/area/template_noop)
"aH" = (/obj/random/pack/cloth/low_chance,/turf/simulated/floor/tiled/techmaint,/area/template_noop)
"aJ" = (/obj/structure/cable/green{d2 = 2; icon_state = "0-2"},/turf/simulated/floor/tiled/techmaint,/area/template_noop)
"aK" = (/obj/machinery/light/small{dir = 1},/turf/simulated/floor/tiled/techmaint,/area/template_noop)
"aL" = (/obj/machinery/door/airlock/maintenance_common{name = "Service Maintenance"; req_access = list(12)},/turf/simulated/floor/tiled/steel/techfloor_grid,/area/template_noop)
"aM" = (/obj/structure/table/rack,/obj/random/pack/tech_loot/onestar,/turf/simulated/floor/tiled/techmaint,/area/template_noop)
"aN" = (/obj/structure/cable/green{d1 = 4; d2 = 8; icon_state = "4-8"},/obj/machinery/atmospherics/pipe/simple/hidden/supply{dir = 4},/obj/random/scrap/dense_weighted,/turf/simulated/floor/plating/under,/area/template_noop)
"aO" = (/obj/structure/disposalpipe/segment{dir = 4},/obj/structure/railing{dir = 1; tag = "icon-railing0 (NORTH)"},/obj/structure/cable/green{d1 = 1; d2 = 2; icon_state = "1-2"},/obj/machinery/atmospherics/pipe/simple/hidden/scrubbers{dir = 4},/turf/simulated/floor/plating/under,/area/template_noop)
"aP" = (/obj/structure/disposalpipe/segment{dir = 4},/obj/structure/railing{dir = 1; tag = "icon-railing0 (NORTH)"},/obj/machinery/atmospherics/pipe/simple/hidden/scrubbers{dir = 4},/turf/simulated/floor/plating/under,/area/template_noop)
"aQ" = (/obj/structure/disposalpipe/segment{dir = 4},/obj/structure/railing{dir = 1; tag = "icon-railing0 (NORTH)"},/obj/structure/railing{dir = 4; tag = "icon-railing0 (EAST)"},/obj/machinery/atmospherics/pipe/simple/hidden/scrubbers{dir = 4},/turf/simulated/floor/plating/under,/area/template_noop)
"aR" = (/obj/random/pack/cloth/low_chance,/turf/simulated/floor/tiled/techmaint_panels,/area/template_noop)
"aS" = (/obj/random/scrap/dense_weighted,/turf/simulated/floor/tiled/techmaint_panels,/area/template_noop)
"aT" = (/obj/random/junk,/turf/simulated/floor/tiled/techmaint_panels,/area/template_noop)
"aU" = (/obj/structure/cable/green{d1 = 4; d2 = 8; icon_state = "4-8"},/obj/structure/cable/green{d1 = 1; d2 = 8; icon_state = "1-8"},/obj/machinery/atmospherics/pipe/simple/hidden/supply{dir = 4},/turf/simulated/floor/plating/under,/area/template_noop)
"aV" = (/obj/random/closet_maintloot/low_chance,/turf/simulated/floor/tiled/techmaint_panels,/area/template_noop)
"aW" = (/obj/structure/cable/green{d1 = 4; d2 = 8; icon_state = "4-8"},/obj/machinery/atmospherics/pipe/simple/hidden/supply{dir = 4},/turf/simulated/floor/plating/under,/area/template_noop)
"aX" = (/obj/structure/railing{dir = 4; tag = "icon-railing0 (EAST)"},/obj/structure/cable/green{d1 = 4; d2 = 8; icon_state = "4-8"},/obj/machinery/atmospherics/pipe/simple/hidden/supply{dir = 4},/turf/simulated/floor/plating/under,/area/template_noop)
"aY" = (/obj/structure/table/rack,/obj/random/gun_cheap/low_chance,/turf/simulated/floor/tiled/steel/gray_platform,/area/template_noop)
"aZ" = (/obj/structure/table/rack,/obj/random/gun_energy_cheap/low_chance,/turf/simulated/floor/tiled/steel/gray_platform,/area/template_noop)
"ba" = (/obj/structure/table/rack,/obj/random/firstaid/low_chance,/turf/simulated/floor/tiled/steel/gray_platform,/area/template_noop)
"bb" = (/obj/structure/reagent_dispensers/fueltank/huge,/turf/simulated/floor/tiled/techmaint_panels,/area/template_noop)
"bc" = (/turf/template_noop,/area/template_noop)
"bd" = (/obj/random/pack/cloth/low_chance,/turf/simulated/floor/tiled/steel,/area/template_noop)
"be" = (/obj/machinery/light{dir = 1},/turf/simulated/floor/tiled/steel,/area/template_noop)
"bf" = (/mob/living/simple_animal/hostile/carp/baby,/turf/simulated/floor/tiled/steel,/area/template_noop)
"bg" = (/obj/structure/cable/green{d1 = 4; d2 = 8; icon_state = "4-8"},/obj/random/scrap/dense_weighted,/turf/simulated/floor/plating/under,/area/template_noop)
"bh" = (/obj/structure/disposalpipe/segment,/obj/structure/catwalk,/obj/structure/cable/green{d1 = 4; d2 = 8; icon_state = "4-8"},/obj/machinery/atmospherics/pipe/simple/hidden/scrubbers,/obj/random/mob/carp,/turf/simulated/floor/plating/under,/area/template_noop)
"bi" = (/mob/living/simple_animal/hostile/carp,/turf/simulated/floor/plating/under,/area/template_noop)
"bj" = (/obj/machinery/door/firedoor,/obj/machinery/door/airlock{name = "Unisex Restrooms"},/turf/simulated/floor/tiled/steel/cargo,/area/template_noop)
"bk" = (/obj/structure/cable/green{d2 = 4; icon_state = "0-4"},/turf/simulated/floor/plating/under,/area/template_noop)
"bl" = (/obj/random/pack/cloth/low_chance,/turf/simulated/floor/plating/under,/area/template_noop)
"bm" = (/obj/structure/disposalpipe/segment,/obj/structure/catwalk,/obj/machinery/atmospherics/pipe/simple/hidden/scrubbers,/turf/simulated/floor/plating/under,/area/template_noop)
"bn" = (/obj/structure/table/rack,/obj/machinery/light/small{dir = 8},/turf/simulated/floor/plating/under,/area/template_noop)
"bo" = (/turf/simulated/floor/tiled/steel,/area/template_noop)
"bq" = (/obj/machinery/light/small{dir = 8},/turf/simulated/floor/plating/under,/area/template_noop)
"br" = (/obj/machinery/camera/network/second_section{dir = 1},/obj/random/scrap/dense_weighted,/turf/simulated/floor/plating/under,/area/template_noop)
"bs" = (/obj/structure/disposalpipe/segment,/obj/structure/catwalk,/obj/machinery/atmospherics/pipe/simple/hidden/scrubbers,/obj/machinery/light/small{dir = 8},/turf/simulated/floor/plating/under,/area/template_noop)
"bt" = (/obj/structure/railing{dir = 8; tag = "icon-railing0 (WEST)"},/obj/structure/cable/green{d1 = 1; d2 = 2; icon_state = "1-2"},/obj/machinery/atmospherics/pipe/simple/hidden/supply,/turf/simulated/floor/plating/under,/area/template_noop)
"bu" = (/obj/structure/closet/oldstyle,/turf/simulated/floor/plating/under,/area/template_noop)
"bv" = (/obj/structure/toilet{dir = 4},/obj/machinery/light{dir = 1},/turf/simulated/floor/tiled/steel,/area/template_noop)
"bw" = (/obj/structure/cable/green{d1 = 1; d2 = 4; icon_state = "1-4"},/turf/simulated/floor/plating/under,/area/template_noop)
"by" = (/obj/machinery/door/airlock/maintenance_interior{name = "Reserve Storage"; req_access = list(12)},/obj/structure/cable/green{d1 = 4; d2 = 8; icon_state = "4-8"},/turf/simulated/floor/tiled/techmaint_cargo,/area/template_noop)
"bA" = (/obj/structure/catwalk,/obj/structure/cable/green{d1 = 4; d2 = 8; icon_state = "4-8"},/turf/simulated/floor/plating/under,/area/template_noop)
"bC" = (/obj/structure/railing{dir = 8; tag = "icon-railing0 (WEST)"},/obj/structure/cable/green{d1 = 2; d2 = 8; icon_state = "2-8"},/obj/structure/cable/green{d1 = 1; d2 = 2; icon_state = "1-2"},/obj/machinery/atmospherics/pipe/simple/hidden/supply,/turf/simulated/floor/plating/under,/area/template_noop)
"bD" = (/turf/simulated/floor/plating/under,/area/template_noop)
"bE" = (/mob/living/simple_animal/hostile/carp,/turf/simulated/floor/tiled/techmaint,/area/template_noop)
"bG" = (/obj/effect/decal/cleanable/blood/oil,/obj/random/closet_tech/low_chance,/turf/simulated/floor/plating/under,/area/template_noop)
"bJ" = (/obj/structure/disposalpipe/segment,/obj/structure/railing{dir = 1; tag = "icon-railing0 (NORTH)"},/obj/machinery/atmospherics/pipe/simple/hidden/scrubbers,/turf/simulated/floor/plating/under,/area/template_noop)
"bK" = (/obj/structure/cable/green{d1 = 1; d2 = 2; icon_state = "1-2"},/obj/machinery/atmospherics/pipe/simple/hidden/supply,/turf/simulated/floor/plating/under,/area/template_noop)
"bN" = (/obj/structure/catwalk,/obj/random/material/low_chance,/turf/template_noop,/area/template_noop)
"hI" = (/obj/random/junk/low_chance,/turf/simulated/floor/plating/under,/area/template_noop)
"lS" = (/obj/structure/catwalk,/obj/random/junk/low_chance,/turf/template_noop,/area/template_noop)
"md" = (/obj/random/mob/carp,/turf/template_noop,/area/template_noop)
"mW" = (/turf/simulated/floor/tiled/steel/cargo,/area/template_noop)
"pu" = (/obj/random/structures/low_chance,/turf/template_noop,/area/template_noop)
"qJ" = (/obj/random/material/low_chance,/turf/template_noop,/area/template_noop)
"rf" = (/mob/living/simple_animal/hostile/carp/baby,/obj/random/junk/low_chance,/turf/simulated/floor/tiled/steel,/area/template_noop)
"uM" = (/obj/structure/disposalpipe/segment{dir = 4},/obj/structure/railing{dir = 1; tag = "icon-railing0 (NORTH)"},/obj/machinery/atmospherics/pipe/simple/hidden/scrubbers{dir = 4},/obj/random/mob/carp,/turf/simulated/floor/plating/under,/area/template_noop)
"zt" = (/obj/random/junk/low_chance,/turf/simulated/floor/tiled/techmaint,/area/template_noop)
"Af" = (/obj/random/circuitboard/low_chance,/turf/simulated/floor/plating/under,/area/template_noop)
"Bg" = (/obj/random/closet_tech/low_chance,/turf/simulated/floor/tiled/steel,/area/template_noop)
"FE" = (/obj/random/material/low_chance,/turf/simulated/floor/tiled/techmaint,/area/template_noop)
"GU" = (/obj/random/mob/carp,/turf/simulated/floor/tiled/techmaint,/area/template_noop)
"HS" = (/obj/random/cloth/armor,/turf/simulated/floor/tiled/techmaint,/area/template_noop)
"IL" = (/obj/structure/lattice,/obj/random/junk/low_chance,/turf/template_noop,/area/template_noop)
"ME" = (/obj/structure/lattice,/obj/structure/lattice,/obj/random/junk/low_chance,/turf/template_noop,/area/template_noop)
"NO" = (/obj/random/mob/carp,/obj/structure/lattice,/turf/template_noop,/area/template_noop)
"Qf" = (/obj/structure/lattice,/obj/random/structures/low_chance,/turf/template_noop,/area/template_noop)
"QP" = (/obj/random/junk/low_chance,/turf/template_noop,/area/template_noop)
"Xz" = (/obj/random/material/low_chance,/turf/simulated/floor/plating/under,/area/template_noop)
"XK" = (/obj/random/closet_tech/low_chance,/turf/simulated/floor/tiled/techmaint,/area/template_noop)
"ZY" = (/obj/structure/lattice,/obj/random/material/low_chance,/turf/template_noop,/area/template_noop)

(1,1,1) = {"
agaghIabbcQPbcbcbcagILZYbcbcbcbcbcbcQPQPbcbcagafag
bDacztXzbcQPpubcqJaghIagabMEabbcQPbcbcbcQPqJbcbDad
agZYagZYQPbcbcbcQPagafagabqJabababqJbcbcILbcQPZYae
QPQPbcbcbcbcbcQPabadbDadadaeaeahadaeaeaeadaeababbc
bcQPbcpubcmdQfabZYadbiaiHSbDbDbDalaGbEaGalbDbDILab
bcababQPbcababILabadadadadaeZYaeadaeaeaeadaeaeagab
bcILabbcQPabbcQPqJabQPbcILbcbcQPILbcbcbcZYbcbcbcab
bcILbcpuQPabILbcbcabbcbcabbcqJbcababadadadadadmdab
bcabNObcQPbcQfabadadadagabagbcagagadadajajakadadab
bcQfbcbcQPbcabXzamanaoarasagqJadabapavGUaGaGaGapab
bcabQPbcbcZYbDaxbDGUaGbDayadadadbDatauaGaGaGaAatbc
bcILbcQPILabaxaxmWaGbEaBaGaiaGGUasataGaDasbDbDatbc
bcbcbcbcabadadazadaCaCFEaHagaGataDatXKaMbDabZYILbc
bcbcpubcbcabadaHatatatatagagaiagatatatatatagagILbc
bcQPqJbcbNQPadaBajatbDILabILILbDGUaGaGaqaKaGaGaaZY
abablSlSbNpuadawaGaLXzILmdQPabaPaPaPaPaOuMaPaPaQab
abagadadadadadadadadagILbcQPabaWaWaWaNaUaWaNaWaXab
aFagaRaSaTbbadbcQPqJagabILagagadadadadadadatatatag
aFabbDbDbDaVagQPQPbcabbmbtagatadaYaZbabdadbebjbDab
aFagbDababatbcQPbcbcadbmbtadBgadbnbDrfboadatatbDZY
aFadbqGUFEaJbDagaeadadbsbtadbfbDILAfbDbuadbvbjasab
abadaGaGaGbwbgbybAbAbAbhbCadaEbDabILabbuagagatbkab
qJadbGXzasblbradaeadblbJbKagAfILabmdqJabagafbjabab
bcadagabadadadadILagabILababbcbcbcbcQPabababqJQPbc
bcabbcqJagbcbcabbcagbcbcbcqJbcQPbcbcQPbcbcbcbcbcbc
"}
