//MAP CONVERTED BY dmm2tgm.py THIS HEADER COMMENT PREVENTS RECONVERSION, DO NOT REMOVE
"a" = (
/obj/random/mob/roaches/low_chance,
/turf/simulated/floor/industrial/cafe_large,
/area/nadezhda/maintenance/undergroundfloor2east)
"h" = (
/obj/item/tool/knife/butch,
/obj/structure/kitchenspike,
/obj/effect/decal/cleanable/blood,
/obj/item/reagent_containers/snacks/meat/monkey,
/obj/item/reagent_containers/snacks/meat/monkey,
/obj/item/reagent_containers/snacks/meat/monkey,
/obj/item/reagent_containers/snacks/meat/monkey,
/obj/random/cloth/gloves,
/turf/simulated/floor/industrial/concrete_bricks,
/area/nadezhda/maintenance/undergroundfloor2east)
"i" = (
/obj/structure/table/rack/shelf,
/obj/item/reagent_containers/snacks/meat,
/obj/item/tool_upgrade/productivity/whetstone,
/obj/item/mop,
/obj/random/rations/roachcube,
/obj/machinery/light/small{
	dir = 4
	},
/turf/simulated/floor/industrial/concrete_bricks,
/area/nadezhda/maintenance/undergroundfloor2east)
"p" = (
/obj/effect/decal/cleanable/blood,
/obj/random/mob/roaches/low_chance,
/turf/simulated/floor/industrial/cafe_large,
/area/nadezhda/maintenance/undergroundfloor2east)
"s" = (
/obj/structure/table/marble,
/obj/item/reagent_containers/snacks/meat/chicken/vox,
/obj/item/reagent_containers/snacks/meat/bearmeat,
/obj/item/storage/box/monkeycubes,
/obj/item/reagent_containers/condiment/saltshaker,
/obj/item/reagent_containers/condiment/peppermill,
/turf/simulated/floor/industrial/concrete_bricks,
/area/nadezhda/maintenance/undergroundfloor2east)
"t" = (
/obj/random/cloth/shoes/low_chance,
/obj/item/reagent_containers/glass/bucket,
/turf/simulated/floor/industrial/cafe_large,
/area/nadezhda/maintenance/undergroundfloor2east)
"K" = (
/obj/structure/table/marble,
/obj/item/reagent_containers/snacks/meat/chicken/vox,
/obj/item/reagent_containers/snacks/monkeysdelight,
/obj/structure/sink/kitchen{
	pixel_y = 32
	},
/obj/random/rations/roachcube,
/turf/simulated/floor/industrial/concrete_bricks,
/area/nadezhda/maintenance/undergroundfloor2east)
"L" = (
/obj/structure/table/rack/shelf,
/obj/item/reagent_containers/snacks/meat/pork,
/obj/item/stack/rods/random,
/obj/item/stack/rods/random,
/obj/random/rations/roachcube,
/turf/simulated/floor/industrial/concrete_bricks,
/area/nadezhda/maintenance/undergroundfloor2east)
"X" = (
/obj/machinery/microwave/burnbarrel,
/obj/item/stack/material/wood/random,
/obj/random/rations/roachcube,
/turf/simulated/floor/industrial/bricks,
/area/nadezhda/maintenance/undergroundfloor2east)

(1,1,1) = {"
h
t
a
"}
(2,1,1) = {"
K
p
X
"}
(3,1,1) = {"
s
i
L
"}
