"a" = (/turf/simulated/wall/r_wall,/area/template_noop)
"b" = (/obj/effect/window_lwall_spawn/smartspawn,/turf/simulated/floor/plating,/area/template_noop)
"c" = (/obj/machinery/atmospherics/pipe/simple/hidden{dir = 4},/turf/simulated/wall,/area/template_noop)
"d" = (/obj/structure/lattice,/obj/random/mob/carp/low_chance,/obj/random/material/low_chance,/turf/template_noop,/area/template_noop)
"e" = (/obj/structure/bed/chair{dir = 1},/obj/random/material/low_chance,/turf/simulated/floor/tiled/techmaint,/area/template_noop)
"f" = (/obj/structure/girder,/turf/simulated/floor/plating/under,/area/template_noop)
"g" = (/obj/structure/table/standard,/obj/random/lowkeyrandom,/obj/random/junkfood/rotten/low_chance,/turf/simulated/floor/tiled/techmaint,/area/template_noop)
"h" = (/obj/random/junk/low_chance,/turf/simulated/floor/tiled/techmaint,/area/template_noop)
"i" = (/obj/random/scrap/dense_weighted/low_chance,/turf/simulated/floor/tiled/techmaint,/area/template_noop)
"j" = (/obj/machinery/door/airlock/maintenance_common{name = "Service Maintenance"; req_access = list(12)},/turf/simulated/floor/tiled/techmaint_cargo,/area/template_noop)
"k" = (/obj/random/scrap/dense_weighted/low_chance,/turf/simulated/floor/plating/under,/area/template_noop)
"l" = (/obj/random/material/low_chance,/turf/template_noop,/area/template_noop)
"m" = (/obj/random/traps,/turf/simulated/floor/tiled/techmaint,/area/template_noop)
"v" = (/obj/structure/lattice,/obj/random/material/low_chance,/turf/template_noop,/area/template_noop)
"z" = (/obj/structure/girder,/obj/random/material/low_chance,/turf/simulated/floor/plating/under,/area/template_noop)
"H" = (/obj/random/scrap/dense_weighted/low_chance,/obj/random/material/low_chance,/turf/simulated/floor/tiled/techmaint,/area/template_noop)

(1,1,1) = {"
dabba
fcega
vchHa
kjmia
laaaz
"}
