//MAP CONVERTED BY dmm2tgm.py THIS HEADER COMMENT PREVENTS RECONVERSION, DO NOT REMOVE
"c" = (
/obj/structure/table/steel,
/obj/random/gun_combat/low_chance,
/obj/random/ammo/low_chance,
/obj/random/ammo/low_chance,
/obj/random/ammo/low_chance,
/turf/simulated/floor/tiled/techmaint,
/area/template_noop)
"e" = (
/obj/structure/table/steel,
/obj/item/device/binoculars,
/turf/simulated/floor/tiled/techmaint,
/area/template_noop)
"g" = (
/obj/structure/table/steel,
/obj/random/gun_energy_cheap,
/obj/random/powercell,
/obj/random/powercell,
/turf/simulated/floor/tiled/techmaint,
/area/template_noop)
"h" = (
/mob/living/simple_animal/hostile/hivebot/range,
/turf/simulated/floor/tiled/techmaint,
/area/template_noop)
"i" = (
/obj/structure/multiz/ladder,
/turf/simulated/floor/tiled/techmaint,
/area/template_noop)
"j" = (
/obj/structure/table/steel,
/obj/structure/salvageable/personal,
/turf/simulated/floor/tiled/techmaint,
/area/template_noop)
"v" = (
/obj/effect/window_lwall_spawn/smartspawn,
/turf/space,
/area/template_noop)
"z" = (
/turf/simulated/wall,
/area/template_noop)
"H" = (
/turf/simulated/floor/tiled/techmaint,
/area/template_noop)
"N" = (
/obj/structure/table/steel,
/obj/random/gun_normal/low_chance,
/obj/random/ammo/low_chance,
/obj/random/ammo/low_chance,
/obj/random/ammo/low_chance,
/turf/simulated/floor/tiled/techmaint,
/area/template_noop)

(1,1,1) = {"
z
v
v
v
z
"}
(2,1,1) = {"
v
c
N
j
v
"}
(3,1,1) = {"
v
e
h
H
v
"}
(4,1,1) = {"
v
g
H
i
v
"}
(5,1,1) = {"
z
v
v
v
z
"}
