"a" = (/obj/random/junk,/turf/simulated/floor/plating/under,/area/template_noop)
"b" = (/turf/template_noop,/area/template_noop)
"c" = (/obj/random/scrap/dense_weighted/low_chance,/turf/simulated/floor/plating/under,/area/template_noop)
"d" = (/turf/simulated/wall/r_wall,/area/template_noop)
"f" = (/obj/structure/girder,/turf/simulated/floor/plating/under,/area/template_noop)
"g" = (/obj/random/junk/low_chance,/turf/simulated/floor/plating/under,/area/template_noop)
"i" = (/turf/simulated/floor/plating/under,/area/template_noop)
"j" = (/mob/living/simple_animal/hostile/carp,/turf/simulated/floor/plating/under,/area/template_noop)
"D" = (/obj/structure/lattice,/turf/template_noop,/area/template_noop)

(1,1,1) = {"
aDfdD
acgic
cijcD
Ddddf
cfDbD
"}
