//MAP CONVERTED BY dmm2tgm.py THIS HEADER COMMENT PREVENTS RECONVERSION, DO NOT REMOVE
"a" = (
/obj/random/scrap/dense_weighted/low_chance,
/turf/simulated/floor/plating/under,
/area/template_noop)
"b" = (
/obj/random/scrap/dense_weighted/low_chance,
/turf/simulated/floor/tiled/techmaint,
/area/template_noop)
"c" = (
/obj/structure/girder,
/turf/simulated/floor/plating/under,
/area/template_noop)
"d" = (
/turf/simulated/floor/plating,
/area/template_noop)
"e" = (
/obj/random/junk,
/turf/simulated/floor/plating/under,
/area/template_noop)
"f" = (
/obj/random/junkfood/rotten/low_chance,
/obj/random/scrap/dense_weighted/low_chance,
/turf/simulated/floor/plating/under,
/area/template_noop)
"g" = (
/obj/random/mob/carp/low_chance,
/turf/simulated/floor/tiled/techmaint,
/area/template_noop)
"h" = (
/turf/simulated/wall,
/area/template_noop)
"i" = (
/obj/random/pack/machine,
/turf/simulated/floor/tiled/techmaint,
/area/template_noop)
"j" = (
/obj/structure/lattice,
/turf/template_noop,
/area/template_noop)
"k" = (
/obj/random/techpart,
/turf/simulated/floor/tiled/techmaint,
/area/template_noop)
"w" = (
/obj/random/junk,
/obj/random/mob/carp/low_chance,
/turf/simulated/floor/plating/under,
/area/template_noop)
"E" = (
/obj/structure/girder,
/obj/random/material/low_chance,
/turf/simulated/floor/plating/under,
/area/template_noop)
"T" = (
/obj/random/mob/carp/low_chance,
/turf/simulated/floor/plating/under,
/area/template_noop)
"V" = (
/obj/structure/lattice,
/obj/random/material/low_chance,
/turf/template_noop,
/area/template_noop)

(1,1,1) = {"
T
e
E
V
f
"}
(2,1,1) = {"
d
d
h
h
d
"}
(3,1,1) = {"
j
b
i
h
w
"}
(4,1,1) = {"
a
g
k
e
f
"}
(5,1,1) = {"
V
h
E
c
V
"}
