//MAP CONVERTED BY dmm2tgm.py THIS HEADER COMMENT PREVENTS RECONVERSION, DO NOT REMOVE
"a" = (
/obj/random/scrap/dense_weighted/low_chance,
/turf/simulated/floor/tiled/techmaint,
/area/template_noop)
"b" = (
/obj/structure/lattice,
/turf/template_noop,
/area/template_noop)
"c" = (
/obj/random/scrap/dense_weighted/low_chance,
/obj/random/material/low_chance,
/turf/simulated/floor/plating/under,
/area/template_noop)
"d" = (
/turf/simulated/wall/r_wall,
/area/template_noop)
"e" = (
/obj/structure/cable/green{
	d1 = 4;
	d2 = 8;
	icon_state = "4-8"
	},
/obj/machinery/atmospherics/pipe/simple/hidden/red{
	dir = 4;
	tag = "icon-intact (EAST)"
	},
/obj/structure/railing{
	dir = 1;
	tag = "icon-railing0 (NORTH)"
	},
/obj/random/scrap/dense_weighted/low_chance,
/obj/random/material/low_chance,
/turf/simulated/floor/plating/under,
/area/template_noop)
"f" = (
/obj/structure/cable/green{
	d1 = 4;
	d2 = 8;
	icon_state = "4-8"
	},
/obj/structure/railing{
	dir = 1;
	tag = "icon-railing0 (NORTH)"
	},
/obj/random/traps/wire_splicing/low_chance,
/turf/simulated/floor/plating/under,
/area/template_noop)
"g" = (
/obj/structure/cable/green{
	d1 = 4;
	d2 = 8;
	icon_state = "4-8"
	},
/obj/structure/railing{
	dir = 1;
	tag = "icon-railing0 (NORTH)"
	},
/obj/random/junk/low_chance,
/turf/simulated/floor/plating/under,
/area/template_noop)
"h" = (
/obj/random/scrap/dense_weighted/low_chance,
/turf/simulated/floor/plating/under,
/area/template_noop)
"i" = (
/obj/structure/cable/green{
	d1 = 4;
	d2 = 8;
	icon_state = "4-8"
	},
/obj/structure/railing{
	dir = 1;
	tag = "icon-railing0 (NORTH)"
	},
/obj/random/scrap/dense_weighted/low_chance,
/obj/random/mob/carp/low_chance,
/turf/simulated/floor/plating/under,
/area/template_noop)
"j" = (
/obj/random/junk/low_chance,
/turf/simulated/floor/plating/under,
/area/template_noop)
"k" = (
/obj/structure/girder,
/obj/random/material/low_chance,
/turf/simulated/floor/plating/under,
/area/template_noop)
"l" = (
/obj/random/toy/plushie_onlycarp,
/turf/simulated/floor/tiled/techmaint,
/area/template_noop)
"m" = (
/obj/random/junk/low_chance,
/turf/simulated/floor/tiled/techmaint,
/area/template_noop)
"s" = (
/obj/structure/lattice,
/obj/random/material/low_chance,
/turf/template_noop,
/area/template_noop)
"P" = (
/obj/structure/lattice,
/obj/random/lowkeyrandom/low_chance,
/turf/template_noop,
/area/template_noop)
"Q" = (
/turf/template_noop,
/area/template_noop)
"R" = (
/obj/random/mob/carp/low_chance,
/turf/template_noop,
/area/template_noop)
"Z" = (
/obj/structure/cable/green{
	d1 = 4;
	d2 = 8;
	icon_state = "4-8"
	},
/obj/structure/railing{
	dir = 1;
	tag = "icon-railing0 (NORTH)"
	},
/obj/random/traps/wire_splicing/low_chance,
/obj/random/lowkeyrandom/low_chance,
/turf/simulated/floor/plating/under,
/area/template_noop)

(1,1,1) = {"
R
P
b
f
s
"}
(2,1,1) = {"
Q
k
l
g
h
"}
(3,1,1) = {"
Q
d
m
e
c
"}
(4,1,1) = {"
b
d
a
i
j
"}
(5,1,1) = {"
k
d
c
Z
s
"}
